あーいん	あーいん 〈合う〉【活】あーたん、あーらん、
あか	あか 〈（頭髪、衣服、船底の）汚れ〉 【例】か
あーけーじゅー	あーけーじゅー 〈トンボ、蜻蛉〉 【参】た
あか	あか 〈赤〉 【例】あかてぃーだ（夕日）、あか
あーすん	あーすん 〈1合わす、2混ぜる〉【活】あーちゃ
あかむん	あかむん 〈赤くなる、果実が色づく〉【活】あ
あがいん	あがいん 〈1上がる、2上達する、悪い方に優
あい、あいこー	あい、あいこー 〈蟻〉 【例】くゎーし 
あが い てぃーだ	あが い てぃーだ〈昇る太陽〉 【例】あ
あかすん	あかすん 〈開ける、明かす〉【活】あかちゃん、
あがた	あがた 〈あちら〉 【例】まーんかい うちゅ
あが やー	あが やー 〈偉い人〉 【例】うみはまてぃ
あかがいん	あかがいん 〈明るくなる〉【活】あかがたん、
あがち	あがち 〈ヤンバルクイナ〉 【例】「やんばるく
あがちゅん	あがちゅん 〈1よく働く、2はかどる〉【活】あ
あかがい	あかがい 〈灯火、明るいところ〉 【例】あ
あかがらすん	あかがらすん 〈明るくする〉【活】あかがら
あかちち	あかちち 〈夜明け、暁〉 【例】あかちちう
あがとー	あがとー 〈あんな遠く〉 【例】なちじんぐし
あぎ	あぎ 〈陸〉 【例】あぎがーみー（陸⻲）、うみが
あきーん	あきーん 〈開く〉【活】あきたん、あきらん、
あがねーいん	あがねーいん 〈節約する〉【活】あがねーた
あぎまーすん	あぎまーすん 〈せきたてる〉【活】あぎま
あがみーん	あがみーん 〈敬う〉【活】あがみたん、あが
あきま どぅし	あきま どぅし 〈新年〉 【例】くじゅん
あがらすん	あがらすん 〈揚げる〉【活】あがらちゃん、あ
あこーくろー	あこーくろー 〈夕暮れ、薄暮〉 【例】あこ
あがらすん	あがらすん 〈完成させる〉【活】あがらちゃ
あさ	あさ 〈朝〉 【例】みーぐち やくとぅ、あさ
あさ なー	あさ なー 〈朝寝坊〉 【例】ふにぬ っう
あさ んなーら	あさ んなーら 〈朝っぱら〉 【例】そーぐ
あし	あし 〈足〉 【例】あしどぅみ（入構禁止、*「ふぃさどぅみ」とは言わない）。あしふぃさ い
あさぐいん	あさぐいん 〈勝手にかき回す〉【活】あさぐ
あし てぃびち	あし てぃびち 〈足手疋（豚足の料理名）〉
あし	あし 〈汗〉 【例】あし はやー（汗かき）。あ
あしぶ	あしぶ 〈あせも〉 【例】んかしぇー あしぶ
あしがちゅん	あしがちゅん 〈あせる〉【活】あしがちゃん、
あじまー	あじまー 〈交差するところ、交差すること〉
あじけー	あじけー 〈シャコガイ〉 【例】うちなーを
あじまー むすび	あじまー むすび 〈十字結び〉 【例】ぐ
あしぶん	あしぶん 〈遊ぶ〉【活】あしだん、あしばん、
あしび	あしび 〈遊び〉 【例】びんちょーん わじ
あち ぶったらー	あち ぶったらー 〈厚着〉 【例】あんすか
あたい	あたい 〈くらい、程度〉 【例】うぬ あたえ
あたいん	あたいん 〈あたる〉【活】あたたん、あたらん、
あちかいん	あちかいん 〈1あつかう、2こき使う〉【活】あ
あちまいん	あちまいん 〈集まる〉【活】あちまたん、あ
あちゃー	あちゃー 〈明日〉 【例】あちゃーん ふぃー
あちゅん	あちゅん 〈明く、開く、空く〉【活】あちゃん、
あち〜	あち〜〈暑、熱、厚〉 【例】あちさん（暑い、熱
あち ぐに	あち ぐに 〈暑い地域〉 【例】うちなーや
あちらすん	あちらすん 〈食べ物を暖める〉【活】あちら
あちりーん	あちりーん 〈熱くなる〉【活】あちりたん、あ
あった ばじょー	あった ばじょー 〈ちらっと見の良さ、見
あちれーゆん	あちれーゆん 〈注文して仕立てる〉【活】あ
あっく すん	あっく すん 〈（上から目線で）叱りつけ
あったみ	あったみ 〈精肉〉 【例】ぶた あったみ（豚
あったる	あったる 〈大事な、大切な〉 【例】あいゑ
あった〜	あった〜〈急〉 【例】っやーや っちゅぬ 
あっちゅん	あっちゅん 〈動きまわる、動く、歩く〉【活】
あてぃーん	あてぃーん 〈当てる〉【活】あてぃたん、あ
あてぃげーふー／あってぃんぷー／あびれー ちごー（ぬ っちゅ）	あてぃげーふー／あってぃんぷー／あびれー ちごー（ぬ っちゅ）〈あてず
あっぺーる／うっぺーる／くっぺーる	あっぺーる／うっぺーる／くっぺーる 〈あの／その／この大きさ〉 【例】っ
あとぅ しーちゅん	あとぅ しーちゅん 〈後ずさりする〉
あとぅ しーちゃー	あとぅ しーちゃー 〈後ずさり〉【活】あと
あとぅない あとぅない	あとぅない あとぅない 〈後ろにひっ
あてぃ	あてぃ 〈思慮、目当て〉 【例】あてぃ なし
あとぅまさい がふー	あとぅまさい がふー 〈後の方の幸運
あばさー、あばし	あばさー、あばし 〈おてんば、針千本〉
あびー くるすん	あびー くるすん 〈大声を出して痛めつけ
あびーん	あびーん 〈大声をだす、声をかける、しゃべ
あふぁげーりーん	あふぁげーりーん 〈気持ちを萎縮させる〉
あふぁなちゅん	あふぁなちゅん 〈寝るの卑語〉【活】あふ
あふぃー	あふぃー 〈兄さん（平⺠）〉 【例】いったー
あふぃらー	あふぃらー 〈アヒル〉 【例】あぬ うぃな
あふぇーいん	あふぇーいん 〈（気が）抜けて水っぽくな
あまいん	あまいん 〈余る〉【活】あまたん、あまらん、
あまみ／あまん ゆー	あまみ／あまん ゆー 〈大昔〉 【例】
あまぐゎし	あまぐゎし 〈ぜんざい〉 【例】あまぐゎし
あまじゃき	あまじゃき 〈酢〉 【例】ういぐゎーぬ 
あや	あや 〈綾、模様〉 【例】あれー むしるぬ 
あやー	あやー 〈お⺟さん（士族）〉 【例】あやめー
あますん	あますん 〈元気が有り余っている〉【活】あま
あやめー くさめー	あやめー くさめー 〈まつわりついてじ
あやかーいん	あやかーいん 〈あやかる〉【活】あやかーた
あやかーらすん	あやかーらすん 〈あやからす〉【活】あや
あわてぃー はーてぃー	あわてぃー はーてぃー 〈急いでいるさ
あやまいん	あやまいん 〈あやまちをする〉【活】あやま
あわり	あわり 〈苦労〉 【例】いくさねー んな だ
あん	あん 〈ある〉 【例】あいにどぅ くばめーゆ
あやまい	あやまい 〈（道徳的な）あやまち〉 【例】ち
あらがーいん	あらがーいん 〈口論する、議論する〉【活】
あんしー かんしー すん	あんしー かんしー すん 〈あれこ
あらげーいん	あらげーいん 〈大きくなり過ぎる〉【活】あ
あらむん	あらむん 〈粗末な食べ物〉 【例】あらむん
あり	あり 〈あれ、あの人〉 【例】ありが むぬん
あんぢゅん	あんぢゅん 〈焼く、あたためる〉【活】あん
あわてぃーん	あわてぃーん 〈急ぐ〉【活】あわてぃたん、
あんだ	あんだ 〈油、脂〉
あんだ がーき	あんだ がーき 〈肉を⻑いこと食べていな
あんだ ぐち	ぃびち’ でも作って食べよう）。あんだ ぐち 〈お世辞〉 【例】みーぬ め
あんべー	あんべー 〈あんばい、気分〉 【例】なまー
あんでぃーん	あんでぃーん 〈こぼれる〉【活】あんでぃた
あんまー	あんまー 〈お⺟さん（平⺠）〉 【例】あやー
あんだすん	あんだすん 〈こぼす〉【活】あんだちゃん、あ
〜い	〜い 〈時、から (理由)〉 【例】わらび そーいに（子どものときに）。あちさいに／あちさ
いーち	いーち 〈息〉 【例】どぅく いちゅなさぬ
いーけーりーん	いーけーりーん 〈中味がすっかりこぼれ
いーち げーい	いーち げーい 〈息抜き、息つぎ〉 【例】
いーけーらすん	いーけーらすん 〈中味をすっかりこぼす〉
いーち ながー	いーち ながー 〈息が⻑い者〉 【例】くー
いーち までぃー すん	いーち までぃー すん 〈窒息する〉
いーび なぎー／いーびがにー	いーび なぎー／いーびがにー 〈指輪〉
いーち みー	いーち みー 〈空気孔〉 【例】うんたまぎ
いーび ぬち	いーび ぬち 〈指差し〉 【例】っちゅんか
いーび ばん	いーび ばん 〈拇印〉 【例】はんこ わし
いーちゅ	いーちゅ 〈絹〉 【例】いーちゅさーに ちゅ
いーび ばんち	いーび ばんち 〈つま弾き〉 【例】ギター
いーび	いーび 〈指〉 【例】てぃーふぃさんかえー 
いーび をぅーい すん	いーび をぅーい すん 〈指を数える〉
いーび んぐゎー	いーび んぐゎー 〈小指〉 【例】ちかぐろ
いーふぇー	いーふぇー 〈位牌〉 【例】いーふぇー だ
いーふぇー なー	いーふぇー なー 〈戒名〉 【例】いーふぇ
いーらー	いーらー 〈くらげ、かつおのえぼし〉 【例】
いー くじーん	いー くじーん 〈皮肉を言う〉 【例】み
いー けーしげーし すん	いー けーしげーし すん 〈何度もくり
いー がーえー	いー がーえー 〈言い争い〉 【例】ちょー
いー っくゎ	いー っくゎ 〈言い過ぎ〉 【例】いーっ
いー しぢーん	いー しぢーん 〈言い過ぎる〉 【例】あれ
いーん	いーん 〈言う〉【活】いちゃん、いらん、いち
いー あーすん	いー あーすん 〈相談する〉 【例】をぅと
いー たてぃーん	いー たてぃーん 〈大げさに言う〉 【例】
いー あーし	いー あーし 〈相談〉 【例】をぅとぅぬ 
いー ちーん	いー ちーん 〈ののしる〉 【例】っちゅぬ
いー ちきーん	いー ちきーん 〈命令する〉 【例】っちゅ
いー ぶさ かってぃー	いー ぶさ かってぃー 〈言い放題〉
いー だてぃ	いー だてぃ 〈大げさ〉 【例】いーだたー
いー ぶん	いー ぶん 〈言い分〉 【例】っやー いー
いー ながしながし すん	いー ながしながし すん 〈口ばかりで
いー みんぐゎすん	いー みんぐゎすん 〈言いまぎらわす〉
いー ならーすん	いー ならーすん 〈言って教える〉【活】〜
いー むどぅすん	いー むどぅすん 〈解消する〉【活】〜むど
いー ぬくすん	いー ぬくすん 〈言い残す〉 【例】いーぬ
いひー あはー	いひー あはー 〈談笑できるさま〉 【例】
いー やんぢゅん	いー やんぢゅん 〈言い損なう〉【活】〜や
いー ほーいん	いー ほーいん 〈言い放つ〉【活】〜ほーた
いー よー	いー よー 〈言い方〉 【例】いーよーぬ 
い くとぅば	い くとぅば 〈言い伝え〉 【例】うふっち
いちゃい はんちゃい	いちゃい はんちゃい 〈ああ言ったり、こ
いーん	いーん 〈要る〉【活】いっちゃん、いらん、い
いく〜	いく〜〈幾〉 【例】いくち（いくつ）、いくた
いくさ	いくさ 〈戦争〉 【例】うぃなごー いくさぬ
いちぇー はんちぇー	いちぇー はんちぇー 〈口答え〉 【例】
いーん	いーん 〈入る〉【活】いっちゃん、いらん、い
いくさぐゎー しぇー	いくさぐゎー しぇー 〈戦ごっこ〉 【例】
いぐますん	いぐますん 〈計画する〉【活】いぐまちゃ
いっちゃい っんぢたい すん	いっちゃい っんぢたい すん 〈出たり
いぐまし	いぐまし 〈企画、事業〉 【例】うちなーぐち
いし くびり	いし くびり 〈石ころの小さな小道〉 【例】
いさとぅー	いさとぅー 〈カマキリ〉 【例】あぬ うぃ
いさみーん	いさみーん 〈励ます〉【活】いさみたん、い
いし	いし 〈石〉
いし じょー	いし じょー 〈石門〉 【例】うちなーぬ 
いし ぢ	いし ぢ 〈礎石〉 【例】いくさをぅてぃ 
いし かぶい じょー	いし かぶい じょー 〈石積みの門〉
いし なーぐー	いし なーぐー 〈小石遊び〉 【例】んか
いし がんとー	いし がんとー 〈石敢當〉 【例】みちぬ
いし きじゃい	いし きじゃい 〈石段〉 【例】くぬ うて
いし ぐー	いし ぐー 〈細かい砂利〉 【例】なーぢゅ
いし みち	いし みち 〈石畳道〉 【例】んかしぬ す
いち ばん どぅい	いち ばん どぅい 〈一番鶏〉 【例】や
いしぇー	いしぇー 〈くわしいこと〉 【例】ぬーんち
いち ぶん	いち ぶん 〈独力で〉 【例】わったー く
いそーさ すん	いそーさ すん 〈嬉しがる〉【活】〜さん、〜
いち	いち 〈池〉 【例】なーんかい っちゅぬ ちゅ
いた ぢり	いた ぢり 〈板切れ〉 【例】んかしぬ わ
いち	いち 〈1〉 【例】いちめー（１枚）、にんめー（２枚）、さんめー（３枚）、ゆんめー（４枚）、ぐ
いち	いち 〈いつ〉 【例】いち すが？／いち ち
いぢ	いぢ 〈勇気、根気、怒り〉 【例】いぢゃー／い
いち でーじ	いち でーじ 〈大変困ったこと〉 【例】て
いち まぶい	いち まぶい 〈生き霊〉 【例】さた しー
いちみとぅ とぅーみー	いちみとぅ とぅーみー 〈一生涯〉 【例】
いちか	いちか 〈いつか〉 【例】いちか まーがな
いち むし／いち むん	いち むし／いち むん 〈動物〉 【例】
いちちゅん	いちちゅん 〈生きる〉【活】いちちゃん、い
いち ぢむ	いち ぢむ〈人間としての心〉 【例】っちゅ
いちからん いちち すん	いちからん いちち すん 〈苦しい生き
いちかすん	いちかすん 〈生かす〉【活】いちかちゃん、
いちまん	いちまん 〈糸満〉 【例】いちまん うぃな
いぢり	いぢり 〈意気地、気力〉 【例】いぢり むん
いち はじ	いち はじ 〈大恥〉 【例】とぅしぢり ス
いちん	いちん 〈意見〉 【例】あれー あびらしぇー
いちゃーすん	いちゃーすん 〈引き逢わす、帳尻を合わせ
いちぇー ぐりー／いちぇー ぐらー	いちぇー ぐりー／いちぇー ぐらー
いちぇー はんすん	いちぇー はんすん〈逢いそびれる〉【活】〜
いちゃさ すん	いちゃさ すん 〈惜しむ〉【活】〜さん、〜
いちゃ がらすー	いちゃ がらすー 〈イカの塩漬け〉 【例】
いちゃいん	いちゃいん 〈出逢う〉【活】いちゃたん、い
いちゃんだ	いちゃんだ 〈ただ、無料〉 【例】んーぢゅ
いちぇー かんてぃー すん	いちぇー かんてぃー すん 〈逢えない
いちゃんだ うい	いちゃんだ うい 〈捨て売り〉 【例】どぅ
いちゃんだ がみ	いちゃんだ がみ 〈ただ食い〉 【例】ぐ
いちゅん	いちゅん 〈行く〉【活】っんぢゃん、いかん、
いちゃんだ ぢけー	いちゃんだ ぢけー 〈ただで使うこと〉
いち しぢとーん	いち しぢとーん 〈行き過ぎる〉 【例】っ
いち むどぅい	いち むどぅい 〈往復〉 【例】しくちんか
いちゃんだ むぬ	いちゃんだ むぬ 〈ただの物〉 【例】いち
いちゅんてー いかんてー すん	いちゅんてー いかんてー すん 〈行く
いちゅく	いちゅく 〈従兄弟〉 【例】ありとぅ わん
いちゅた	いちゅた 〈ちょっとの間〉 【例】いさぬ 
いちぇー ちげー	いちぇー ちげー 〈行き違い〉 【例】あり
いちゅび	いちゅび 〈イチゴ〉 【例】いちゅびぬ か
いっさん	いっさん 〈走って〉 【例】いっさん なて
いっそー	いっそー 〈普段〉 【例】いっそーや あねー
いちぇー かじ	いちぇー かじ 〈出逢いの悪霊〉 【例】
いっそー ちやー	いっそー ちやー 〈普段着〉 【例】くぬ 
いっそー なーでぃー／ちび なーでぃー	いっそー なーでぃー／ちび なーでぃー 〈残らず〉 【例】なー けーい
いなか んちゅ	いなか んちゅ 〈田舎（出身の）者〉 【例】
いったー はらー	いったー はらー 〈あなたたちの側〉
いっとぅがよー	いっとぅがよー 〈おはじき〉 【例】んか
いなむどぅち	いなむどぅち 〈猪料理〉 【例】いなむど
いばいん	いばいん 〈威張る〉 【例】ぬーぬ いばい
いば〜	いば〜〈狭〉 【例】いばさん（狭い）の接頭辞
いば どぅくる	いば どぅくる 〈密集している所〉 【例】
いっとぅち	いっとぅち 〈片時〉 【例】ぐまわらばーか
いとぅいん	いとぅいん 〈嫌がる〉【活】いとぅたん、いと
いばいぬ みー	いばいぬ みー 〈狭苦しいところ〉 【例】
いみ すん	いみ すん 〈量が増す〉【活】〜さん、〜さ
いま	いま 〈新鮮なもの、現世〉 【例】いまいゆ（新
いめんしぇーん	いめんしぇーん 〈いらっしゃる〉【活】いめ
いみ	いみ 〈夢〉 【例】みーくーてぃからー ちゅ
いめんしぇーびーん	いめんしぇーびーん 〈いらっしゃる〉
いみ あき	いみ あき 〈忌み明け〉 【例】いみあけ
いゆ	いゆ 〈魚〉 【例】いちまのー をぅとー い
いみーん	いみーん 〈催促する〉【活】いみたん、いみら
いゆぬ みー	いゆぬ みー 〈魚の目〉 【例】ふぃさぬ
いらーすん	いらーすん 〈一時立て替えて貸す〉【活】い
いらいん	いらいん 〈一時立て替えて借りる〉【活】いら
いらな	いらな 〈鎌〉 【例】うちなーぐゆみぬ しち
いり けーいん	いり けーいん 〈入れ替える〉【活】いりけ
いり けーらすん	いり けーらすん 〈入れ替えさせる〉【活】
いりち	いりち 〈鱗、ふけ〉 【例】いゆぬ いりち
いらぶん	いらぶん 〈選ぶ〉【活】いらだん、いらばん、
いりちゅん	いりちゅん 〈炒める〉【活】いりちゃん、い
いらび ぬくし／いらび ぬくさー	いらび ぬくし／いらび ぬくさー〈選
いらび っんぢゃすん	いらび っんぢゃすん 〈選び出す〉 【例】
いりめー	いりめー 〈収入〉 【例】とぅしじりに ちー
いりーん	いりーん 〈入れる〉【活】いったん、いりら
いりゆー	いりゆー 〈必要〉 【例】っやー いりゆー 
いる ぶり	いる ぶり 〈好色（女性にのみ用いる）〉
いりむくー	いりむくー 〈入り婿〉 【例】いりむくーや
いりわい	いりわい 〈口論〉 【例】いりわい すん（口
いる	いる 〈色、血色〉 【例】めー いちゃたる 
いらー	いらー 〈好色者〉 【例】あれー ぬーんち
いる かじ	いる かじ 〈いろいろ〉 【例】いったー 
いるみー わかすん	いるみー わかすん 〈選り分ける〉【活】
いれーいん	いれーいん 〈答える〉 【例】ふぃじふぃん
いん	いん 〈犬〉 【例】えーそーぬ あたらん っち
いる そー もーそー	いる そー もーそー 〈驚いて顔色が⻘く
うい	うい 〈ウリ〉 【例】ういぐゎーや どぅーぬ
ういん	ういん 〈売る〉【活】うたん、うらん、うてぃ
うららん ぬー	うららん ぬー 〈見切り品〉 【例】うらら
うーえー くーえー すん	うーえー くーえー すん 〈追いつ追わ
ういん	ういん 〈織る〉【活】うたん、うらん、うてぃ
うーいん	うーいん 〈負う〉【活】うーたん、うーらん、
うーいん	うーいん 〈追う、従う〉【活】うーたん、うー
うーく	うーく 〈奥〉 【例】わたくさー どぅーく
うーく ばー	うーく ばー 〈奥⻭〉 【例】うーくばーや
うーくい	うーくい 〈お送り〉 【例】しちぐゎちーぬ 
うーちるがいん	うーちるがいん 〈すっかり浸透する、すっ
うーぐとぅ	うーぐとぅ 〈ありがたいこと、うれしいこ
うーさり あーさり すん	うーさり あーさり すん 〈ぺこぺ
うーちりばんた	うーちりばんた 〈断崖絶壁〉 【例】うー
うーとーとぅ すん	うーとーとぅ すん 〈お祈りする〉【活】〜
うーし	うーし 〈臼〉 【例】んかしぇー むちぐみ 
うーばんばらー すん	うーばんばらー すん 〈がらんとして
うーび	うーび 〈帯〉 【例】うーべー うぃきがぬ 
うーしーん	うーしーん 〈負わせる、疑う〉【活】うーし
うーふぁ	うーふぁ 〈おんぶ〉 【例】しーじゃぬちゃ
うーすん	うーすん 〈負わす〉【活】うーちゃん、うーさ
うかじゃい かび	うかじゃい かび 〈祭壇に供える紙〉
うーふぁ すん	うーふぁ すん 〈おぶる〉【活】〜さん、〜さ
うーふー	うーふー 〈敬語〉 【例】あんどぅ やるん
うかぢ	うかぢ 〈おかげ〉 【例】やぐさみむん や
うかっとぅー	うかっとぅー 〈うっかり者〉 【例】っちゅ
うかみがなしー	うかみがなしー 〈神様〉 【例】ニライカ
うーまくー、うーまく	うーまくー、うーまく 〈腕白、しっかり
うきーん	うきーん 〈浮かべる〉【活】うかちゃん、うか
うかきぶしぇー	うかきぶしぇー 〈お治めになること〉
うきーん	うきーん 〈起きる〉【活】うきたん、うきら
うきじゃま にじゃま	うきじゃま にじゃま 〈起きぬけ〉 【例】
うきにん	うきにん 〈保証人〉 【例】っちゅぬ うき
うき ふぃんとー	うき ふぃんとー 〈受け答え〉 【例】っち
うき にんぢ	うき にんぢ 〈床についたまま起きること〉
うきーん	うきーん 〈受ける、引き受ける〉【活】うきた
うき むち	うき むち 〈受け持ち〉 【例】くんどぅぬ
うきんじゅ はいんじゅ	うきんじゅ はいんじゅ 〈受水走水〉
うき とぅいん	うき とぅいん 〈取得した〉【活】うきとぅ
うき とぅみーん	うき とぅみーん 〈受け止める〉【活】うき
うき どぅい	うき どぅい 〈領収書〉 【例】むぬ こ
うくいん	うくいん 〈送る〉【活】うくたん、うくらん、
うぐしく	うぐしく 〈首里城〉 【例】うぐしくんかえ
うくすん	うくすん 〈起こす〉【活】うくちゃん、うくさ
うくすん	うくすん 〈興す〉【活】うくちゃん、うくさん、
うくりーん	うくりーん 〈初めて起こる〉【活】うくりた
うぐゎん	うぐゎん 〈祈願〉 【例】なーちねーぢねー 
うぐりーん	うぐりーん 〈再発する〉【活】うぐりたん、う
うぐゎん ぐとぅ	うぐゎん ぐとぅ 〈願い事〉 【例】やーに
うくりーん	うくりーん 〈遅れる〉【活】うくりたん、う
うくでぃ	うくでぃ 〈神人〉 【例】なーむんちゅーむ
うぐゎん じゅ	うぐゎん じゅ 〈拝所〉 【例】いしぬ す
うけー（めー）	うけー（めー）〈お粥〉 【例】どぅーぬ 
うぐゎん ぶとぅち	うぐゎん ぶとぅち 〈結願のお礼参り〉
うこー	うこー 〈お線香〉 【例】うちなーや うやふ
うこーる	うこーる 〈香炉〉 【例】うちなーをぅてー
うさーいん	うさーいん 〈合わさる〉【活】うさーたん、う
うさぢ	うさぢ 〈ウサギ〉 【例】うさぢぇー かなさ
うさんでー	うさんでー 〈供え物をさげたもの〉 【例】
うさーすん	うさーすん 〈合わす、抱かせる〉【活】うさ
うし	うし 〈牛〉
うし おーらしぇー	うし おーらしぇー 〈闘牛〉 【例】うち
うしぬ しし	うしぬ しし 〈牛肉〉 【例】んかしぇー 
うさーりーん	うさーりーん 〈襲われる〉【活】うさーりた
うしぬ ちー	うしぬ ちー 〈牛乳〉 【例】うしぬ ちー
うさがいん	うさがいん 〈いただく〉【活】うさがたん、
うしーまーしー	うしーまーしー 〈順々にまわしすこと〉
うしーみー	うしーみー 〈清明祭〉 【例】うしーみーや
うさきー（なー）	うさきー（なー）〈そんなにたくさん〉
うじーん	うじーん 〈恐れをなす、怖じる〉【活】うじた
うし けーらすん	うし けーらすん 〈突き飛ばす〉【活】〜け
うじーちーん	うじーちーん 〈すっかり怖じ気ずく〉【活】
うし ちーん	うし ちーん〈ちょん切る、押しきる〉【活】〜
うしぇーいん	うしぇーいん 〈ばかにする〉【活】うしぇー
うし〜	うし〜〈押し〉
うし ちきーん	うし ちきーん 〈押しつける〉【活】〜ちき
うし ぬきーん	うし ぬきーん 〈押しのける〉【活】〜ぬき
うし くるばーしぇー すん	うし くるばーしぇー すん 〈混雑で押
うし まーすん	うし まーすん 〈きりっと締める〉【活】〜
うし くみーん	うし くみーん 〈押さえつける〉【活】〜く
うし まぎーん	うし まぎーん 〈負かす〉【活】〜まぎた
うし けーすん	うし けーすん 〈押し返す〉【活】〜けーち
うしる	うしる 〈おつゆ〉 【例】「うんじょー うし
うし ゆしーん	うし ゆしーん 〈押し寄せる〉【活】〜ゆし
うし っんぢゃすん	うし っんぢゃすん 〈押し出す〉【活】〜っ
うしる くぶー	うしる くぶー 〈後頭頸部〉 【例】がっ
うし とーすん	うし とーすん 〈押し通す〉【活】〜とーち
うし んちゅん	うし んちゅん 〈押し込む〉【活】〜んちゃ
うしざし	うしざし 〈かんざしの一種〉 【例】んかしぬ
うじゃさー	うじゃさー 〈おじさん〉 【例】うじゃさー
うじゅますん	うじゅますん 〈目を醒させる〉【活】うじ
うしでーく	うしでーく 〈臼太鼓〉 【例】むらまちりを
うじゅむん	うじゅむん 〈目を醒す〉【活】うじゅだん、
うじみーん	うじみーん 〈埋める〉【活】うじみたん、う
うじゅみ	うじゅみ 〈はずみ、きっかけ〉 【例】はじ
うしんちー	うしんちー 〈着物の前の端を腰巻きの紐の
うすでー	うすでー 〈お祝儀〉 【例】うすでーや ち
うすん	うすん 〈押す〉【活】うちゃん、うさん、うち
うすめー	うすめー 〈おじいさん（平⺠）〉 【例】はー
うすりーん	うすりーん 〈敬う〉【活】うすりたん、うすり
うすいん	うすいん 〈かぶせる、抱く〉【活】うすたん、
うすり	うすり 〈敬いの気持ち、畏れ〉 【例】どぅー
うすばすん	うすばすん 〈伏せる〉【活】うすばちゃん、う
うすあかがい	うすあかがい 〈薄明かり〉 【例】してぃ
うた	うた 〈歌〉 【例】うちなーぐちぬ うた ち
うすく	うすく 〈あこう〉 【例】「うすく」んでぃー
うた さー	うた さー 〈歌手〉 【例】あれー ゐー 
うた さんしん	うた さんしん 〈歌三線〉 【例】ふぇーさ
うだーすん	うだーすん 〈おどす、どなりつける〉【活】う
うち	うち 〈内、家の中〉 【例】「ちゃーびら さい」
うたき	うたき 〈御嶽〉 【例】うたきをぅてぃ どぅ
うちーん	うちーん 〈映る、移る〉【活】うちたん、うち
うたとぅくる	うたとぅくる 〈お二人様〉 【例】くまん
うち かび	うち かび 〈紙銭、あの世の紙幣〉 【例】
うたびみしぇーん	うたびみしぇーん 〈いただく〉【活】うた
うちきーん	うちきーん 〈置く〉【活】うちきたん、うち
うち〜	うち〜〈すっかり、まるごと（強調）〉 【例】を
うちくむん	うちくむん 〈雨が屋内に降り込む〉【活】う
うちけー さりやー	うちけー さりやー 〈使いっ走り〉
うちゃいん	うちゃいん 〈似合う〉【活】うちゃたん、う
うちちゅー（ぬ） めー／とーとーがなしーめー	うちちゅー（ぬ） めー／とーとーがなしーめー 〈お月様〉 【例】うちち
うちなー ぐち	うちなー ぐち 〈沖縄語〉 【例】うちな
うちゃたい かなたい すん	うちゃたい かなたい すん 〈たが
うちなー ゆー	うちなー ゆー 〈沖縄世〉 【例】ふぇーば
うちゃーすん	うちゃーすん 〈打ち合わす、協力する〉【活】
うちゃがいん	うちゃがいん 〈見違える〉【活】うちゃがた
うちながにー	うちながにー 〈肩ロース〉 【例】うちなが
うちなすん	うちなすん 〈済ます〉【活】うちなちゃん、う
うちゃぎーん	うちゃぎーん 〈上に向く〉【活】うちゃぎた
うちゅん	うちゅん 〈打つ〉【活】うちゃん、うたん、う
うちゃとー みんとー	うちゃとー みんとー 〈お茶とお水の
うちゃ ふかしぇー	うちゃ ふかしぇー 〈お茶会〉 【例】や
うちゃく	うちゃく 〈お客〉 【例】うちゃくぬ みち
うちゅくぃー	うちゅくぃー 〈ふろしき〉 【例】うちゅ
うちゅん	うちゅん 〈浮く〉【活】うちゃん、うかん、う
うちぇー かねー すん	うちぇー かねー すん 〈兼ね備え
うちぇーいみしぇーん	うちぇーいみしぇーん 〈おいで遊ばす〉
うちり びー	うちり びー 〈おき火、赤く熱した炭火〉
うちゅすん	うちゅすん 〈映す、移す〉【活】うちゅちゃ
うてぃーん	うてぃーん 〈落ちる〉【活】うてぃたん、う
うてぃ しじみ	うてぃ しじみ 〈没落〉 【例】にんぢんぬ
うてぃらー くゎー さがらー くゎ	うてぃらー くゎー さがらー くゎ
ー すん	ー すん 〈物欲しそうにする〉【活】〜さん、〜
うっさ〜	うっさ〜〈嬉しさ〉 【例】うっさん（嬉しい）
うっさ くゎったー すん	うっさ くゎったー すん 〈有頂天にな
うっさ ふくらさ すん	うっさ ふくらさ すん 〈非常に嬉しい〉
うっか	うっか 〈負債〉 【例】うっか かんてぃ ま
うっか ばれー	うっか ばれー 〈負債払い〉 【例】なげー
うっけーりーん	うっけーりーん 〈転ぶ、反転する〉【活】う
うったー	うったー 〈その人たち〉 【例】うったーや
うっちゃかいん	うっちゃかいん 〈よりかかる、頼る〉【活】
うっけーらすん	うっけーらすん 〈ひっくり返す〉【活】う
うっちゃんぎーん	うっちゃんぎーん 〈放り出す、置き去り
うっくるぶん	うっくるぶん 〈転倒する〉【活】うっくるだ
うっちんきーん	うっちんきーん 〈うつぶせる、伏せる〉【活】
うっちんとぅー	うっちんとぅー 〈うつぶせ〉【活】〜さん、〜
うっちぇーいん	うっちぇーいん 〈裏返る〉【活】うっちぇ
うっちぇーすん	うっちぇーすん 〈裏返す〉【活】うっちぇ
うってーいん	うってーいん 〈訴える〉【活】うってーた
うっちぇー ふぃっちぇー すん	うっちぇー ふぃっちぇー すん 〈しき
うっとぅ	うっとぅ 〈年下、弟妹〉 【例】わんにんか
うっとぅ しーじゃ	うっとぅ しーじゃ〈年下年上、兄姉弟妹〉
うっちん	うっちん 〈ウコン〉 【例】うっちのー ち
うっとぅ まき	うっとぅ まき 〈おとみづわり〉【活】＝う
うっとぅ をぅない	うっとぅ をぅない 〈（兄から見た）妹〉
うっとぅ んぐゎ	うっとぅ んぐゎ 〈末っ子〉 【例】まーぬ
うでぃ まっくゎ	うでぃ まっくゎ 〈腕枕〉 【例】わらび
うっとぅばすん	うっとぅばすん 〈吹き飛ばす〉【活】うっ
うてぃら めー	うてぃら めー 〈拝所参り、お寺参り〉
うとぅ	うとぅ 〈音、便り、評判〉 【例】をぅどぅい
うっぴ	うっぴ 〈それだけの大きさ〉 【例】あいこー
うっぴぐゎー	うっぴぐゎー 〈それっぽち〉 【例】うっぴ
うっぴなー	うっぴなー 〈そんなに大きな〉 【例】うっ
うっぺーる	うっぺーる 〈そんなに大きな〉 【例】うっ
うとぅいむち	うとぅいむち 〈接待、おもてなし〉 【例】
うてぃちち	うてぃちち 〈落ち着き、沈着さ〉 【例】と
うどぅるかすん	うどぅるかすん 〈驚かす〉【活】うどぅる
うどぅきーん	うどぅきーん 〈商売で失敗する〉【活】うど
うとぅるさ むん	うとぅるさ むん 〈恐ろしいもの〉 【例】
うとぅげー なんどぅるー	うとぅげー なんどぅるー 〈顎がツ
うとぅすん	うとぅすん 〈移す〉【活】うとぅちゃん、う
うとぅすん	うとぅすん 〈落とす〉【活】うとぅちゃん、う
うとぅし むん	うとぅし むん 〈落とし物〉 【例】うとぅ
うとぅち あがち	うとぅち あがち 〈優劣、浮沈〉 【例】っ
う〜	う〜〈中称の指示詞〉
う なぎー	う なぎー 〈それぐらいの⻑さ〉 【例】「ち
う なげー	う なげー 〈そんなに⻑く〉 【例】っやー
うぬ／くぬ／あぬ ひゃー	うぬ／くぬ／あぬ ひゃー 〈そいつ／こ
うぬ／くぬ／あぬ よー	うぬ／くぬ／あぬ よー 〈その／この／
うふぃなー	うふぃなー 〈それだけの〉 【例】いっぺー
うふぃなー なーぬ	うふぃなー なーぬ 〈そんなに大きな〉
うどぅるちゅん	うどぅるちゅん 〈驚く〉【活】うどぅるち
うんにー	うんにー 〈その時〉 【例】うんにーから 
うびらじ ぐとぅ	うびらじ ぐとぅ 〈不意の出来事〉 【例】
うはち	うはち 〈お初〉 【例】なーだ たーがん て
うぶく	うぶく 〈神仏に供えるご飯〉 【例】ちーたち
うびーん	うびーん 〈憶える〉【活】うびたん、うびら
うびー	うびー 〈記憶〉 【例】あぬ っちょー ま
うふ〜	うふ〜〈多、大〉 【例】うふさん（多い）から
うふさに かたぢきるー	うふさに かたぢきるー 〈多数決〉 【例】
うふ そー むん	うふ そー むん〈そそっかしい者〉 【例】
うび っんぢゃすん	うび っんぢゃすん〈思い出す〉 【例】ち
うふ あや	うふ あや 〈大柄〉【活】うふ がら ぢん
うふ ぐぃー	うふ ぐぃー 〈大声〉 【例】うふぐぃー 
うびーなでぃー	うびーなでぃー 〈水撫で〉 【例】そーぐ
うふ ぐすーじ	うふ ぐすーじ 〈盛大な祝い〉 【例】と
うふ ぬすどぅ	うふ ぬすどぅ 〈大泥棒〉 【例】うふぬす
うー ぐとぅ	うー ぐとぅ 〈大ごと〉 【例】っやーや 
うふ ぢむー	うふ ぢむー 〈気前がいい者〉 【例】っう
うふ まちや	うふ まちや 〈大きな店〉 【例】うふまち
うふ むにー	うふ むにー 〈偉そうなことばを使うこと〉
うふ じん	うふ じん 〈大金〉 【例】うふじん ゐー
うふ すー	うふ すー 〈ご主人〉 【例】うふすーや 
うふ ちねー	うふ ちねー 〈大家族〉 【例】うふちねー
うふ むぬ いー	うふ むぬ いー 〈大言壮語〉 【例】うふ
うふ ちぶらー	うふ ちぶらー 〈頭でっかち〉 【例】ちぶ
うふ やー	うふ やー 〈本家〉 【例】うふやーんかえ
うふ にんじゅ	うふ にんじゅ 〈大人数〉 【例】なまぬ 
うふ やしー	うふ やしー 〈おとなしい者〉 【例】うふ
うふ わた	うふ わた 〈大きいお腹〉【活】うふ わた
うふ っんぶし	うふ っんぶし 〈重荷〉 【例】やっとぅか
うふ やっちー	うふ やっちー 〈⻑兄（士族）〉【活】うふ
うふ ゆくー	うふ ゆくー 〈強欲者〉 【例】どぅーぬ 
うふ ゆくし むにー さー	うふ ゆくし むにー さー 〈大嘘つき〉
うぶん にぢり	うぶん にぢり 〈握り飯〉 【参】「にぢり
うまんちゅ	うまんちゅ 〈多くの人〉 【例】しまくと
うみ〜	うみ〜〈〜様〉 【例】うみさとぅ (めー)、うみしーじゃ、うみたるーんでーんかい ちからっ
うみ	うみ 〈海〉
うみ あっちゃー	うみ あっちゃー 〈漁師〉 【例】うみあ
うみ がーみー	うみ がーみー 〈海⻲〉 【例】うみがーみ
うみ ばた	うみ ばた 〈海岸〉 【例】うみばたぬ ま
うぶちだん	うぶちだん 〈お仏壇〉 【例】あれー ちゃく
うみ っんまぐゎー	うみ っんまぐゎー 〈タツノオトシゴ〉
うまちー	うまちー 〈農耕のお祭り〉 【例】うまちー
うみかきーん	うみかきーん 〈お目にかける、ご覧にいれ
うみ やみー すん	うみ やみー すん〈思い悩む〉 【例】し
うみー くみー	うみー くみー 〈思いやり〉 【例】あれー
うみ たち	うみ たち 〈思い立ち〉 【例】うみたちど
うむいん	うむいん 〈思う〉【活】うむたん、うむらん、
うみ ちーん	うみ ちーん 〈思い切る〉 【例】すんでぃ
うむい ちみーん	うむい ちみーん 〈思いつめる〉【活】う
うみ ちり	うみ ちり 〈思い切り〉 【例】ゆーわたい
うみん ゆらん くとぅ	うみん ゆらん くとぅ 〈思いがけない
うむ かぢ	うむ かぢ 〈面影〉 【例】うむかぢぬ た
うむ むち	うむ むち 〈目的、わけ、顔つき〉 【例】
うみ ちーん	うみ ちーん 〈あきらめる〉 【例】うりと
うむ やー	うむ やー 〈好きな人、思いやりのある人〉
うみ はまいん	うみ はまいん 〈努力する、一生懸命する〉
うや がなしー	うや がなしー 〈親御〉 【例】うやがなし
うみ ゆいん	うみ ゆいん 〈思いおよぶ〉【活】うみゆた
うや っくゎ	うや っくゎ 〈親子〉 【例】なちやしみ 
うみ んぐゎ	うみ んぐゎ 〈お子さん〉 【例】うみんぐ
うむてぃ	うむてぃ 〈表〉 【例】たーんかい やてぃ
うむてぃ ぢら	うむてぃ ぢら 〈作り顔〉 【例】ちもー 
うや なけーし むん／うや なけーしんぐゎ	うや なけーし むん／うや なけーしんぐゎ 〈親不孝者〉 【例】うやなけーし
うや ぬちゃー＜	うや ぬちゃー＜ 〈両親〉 【例】いったー
うや までぃー	うや までぃー 〈親なし〉 【例】うやまで
うむる うそーし	うむる うそーし 〈おもろ御そうし〉
（うや）ふぁーふじ	（うや）ふぁーふじ 〈祖先〉 【例】うち
うめーし、めーし	うめーし、めーし 〈お箸、箸〉 【例】まか
うや まさいんぐゎ	うや まさいんぐゎ 〈親勝りの子〉 【例】
うや	うや 〈親〉 【例】うや ゆし っくゎ ゆし。
うや がかい	うや がかい 〈親の庇護の下にあること〉
うやぎー	うやぎー 〈お祝いの金銭や物資の援助〉 【例】
うゆばん	うゆばん 〈及ばない〉 【例】ちゃっさ さ
うゆうぇー／うーうぇー	うゆうぇー／うーうぇー 〈お祝い〉
うらんだー	うらんだー 〈⻄洋人〉 【例】うらんだすが
うら	うら 〈裏〉 【参】うむてぃ。
うら じゃ	うら じゃ 〈裏座〉 【例】うらじゃー う
うり さい／たい	うり さい／たい 〈ほら（目上に）〉 【例】
うらごーさ	うらごーさ〈嫉妬、ねたみ〉 【例】どぅーや
うら むにー	うら むにー 〈逆のことを言うこと〉 【例】
うりーっさ、うり ひゃー	うりーっさ、うり ひゃー 〈それっ
うらーきーん	うらーきーん 〈水に浸す〉【活】うらきた
うり／あり／くり	うり／あり／くり 〈それ／あれ／これ〉
うりかー／ありかー／くりかー	うりかー／ありかー／くりかー 〈そ
っんまかー	っんまかー 〈その辺り〉 【例】うぬくる 
うり からー	うり からー 〈それから、それ以後は〉
うり くる	うり くる〈その人自身で〉 【例】うっぴぐ
うり よー あり よー	うり よー あり よー 〈あたらずさわ
うるすん	うるすん 〈下ろす〉【活】うるちゃん、うるさ
うるにー なまにー すん	うるにー なまにー すん 〈半煮え
うんぐとーるー	うんぐとーるー 〈そんなもの〉 【例】な
うりーん	うりーん 〈降りる〉【活】うりたん、うりら
うりーん	うりーん 〈売れる〉【活】うりたん、うりら
〜うるみ	〜うるみ 〈〜頃〉 【例】うちなーぐゆみぬ
うりー	うりー 〈潤い〉 【例】ゐー うりー なてぃ
うわいん	うわいん 〈終わる〉【活】うわたん、うわら
うりじん	うりじん 〈旧暦 2〜3 月、初春〉 【例】うりじんべーぬ ふちーねー、ゐーはだむち なて
うんけー すん	うんけー すん 〈お迎えする〉【活】〜さ
うる	うる 〈砂、砂利、珊瑚の骨軸〉 【例】くまぬ
うんじゅ	うんじゅ 〈あなた様、ご自身〉 【例】うぬ
うんじゅ なー	うんじゅ なー〈あなた様（さらに丁寧に）〉
うんち／ぬんち／みゅんち	うんち／ぬんち／みゅんち 〈お顔〉
うんちょーび／ぬんちょーび／みゅんちょーび	うんちょーび／ぬんちょーび／みゅんちょーび 〈髪の敬称〉 【例】から
うんぬかゆん	うんぬかゆん 〈お聞きになる〉【活】うんぬ
うんちぇー すん	うんちぇー すん 〈お借りする〉【活】〜
うんぬきーん	うんぬきーん 〈申し上げる〉【活】うんぬき
うんちけー する	うんちけー する 〈案内、お迎え、ご招
えーじ	えーじ 〈合図〉 【例】けーいる ばすねー、
えーじゅー	えーじゅー 〈同僚、仲間〉 【例】あれー 
えーすん	えーすん 〈潰す〉【活】えーちゃん、えーさ
えーてぃ	えーてぃ 〈相手〉 【例】わらびんちゃーぬ
えー むん	えー むん 〈和え物〉 【例】んぢゃなばー
おーいん	おーいん 〈頭をあわせてけんかする〉【活】お
おえー	お えー 〈けんか〉 【例】おーえー むんど
おーかじ	おーかじ 〈静脈〉 【例】あれー おーかじ
おーえー むしー	おーえー むしー 〈けんか好き〉 【例】お
おーらすん	おーらすん 〈頭をあわせてけんかさせる〉
おー さび	おー さび 〈⻘錆び〉 【例】くぢぬ さび
おーじゃー にーしぇーぐゎー	おーじゃー にーしぇーぐゎー 〈⻘二
おー だむん	おー だむん 〈まだ枯れていない薪〉 【例】
おーじゃー	おーじゃー 〈⻘〉 【例】っやー ちらー 
おー ぬーい	おー ぬーい 〈⻘のり〉 【例】おーぬーえ
おーぐらしん	おーぐらしん 〈真っ暗闇〉 【例】おーぐ
おーびちぇー、おーびちゃい	おーびちぇー、おーびちゃい 〈⻘光り〉
おーふぁ	おーふぁ 〈⻘野菜〉 【例】やーしぇーやー
おー べー	おー べー 〈⻘蠅〉 【例】ふぇーんかえー、
おーだー	おーだー 〈もっこ〉 【例】おーだーや、っ
おーちび	おーちび 〈ビリ〉 【例】っやーや びんち
おーぢゅん	おーぢゅん 〈扇ぐ〉【活】おーぢゅん、おー
おー まーみー	おー まーみー 〈緑豆〉 【例】おーまーみ
おーとー	おーとー 〈ミカンの一種〉 【例】うちなー
おー むん	おー むん 〈熟していない果実〉 【例】う
おーふぃじゅる かんじゃー	おーふぃじゅる かんじゃー 〈寒々
おーるー びー	おーるー びー 〈⻘火＝⻤火〉 【例】お
かー	かー 〈井戸〉 【例】かーや ちーさーに み
がー	がー 〈意地、自我〉 【例】がー はいん。（我
かー	かー 〈皮〉 【例】かーぐつ（皮靴）、かーじゃ
かー かんぢゃー	かー かんぢゃー〈目がかすむこと〉 【例】
がー えー	がー えー〈威勢づけ〉 【例】なーふぁぬ 
かー はっぱいん	かー はっぱいん〈強く張り伸ばす〉【活】〜
かー びしー	かー びしー 〈皮のうすい者、もの〉 【例】
かっ ぱやー すん	かっ ぱやー すん〈（水分が抜けて）皮張
かーがー	かーがー 〈（水面、鏡、地面などに）映る影〉
やま かーがー	やま かーがー 〈人見知り〉 【例】をぅと
かーきーん	かーきーん 〈乾く、渇く〉【活】かーきたん、
かーぎ	かーぎ 〈容貌、姿、陰〉 【例】かーげー か
かーき のーし	かーき のーし 〈渇き直し〉 【例】でぃー、
かーぎ ぶし	かーぎ ぶし 〈陰干し〉 【例】しんじむん
かーかすん	かーかすん 〈干す、乾かす〉【活】かーかち
かーさ	かーさ 〈広い葉〉 【例】くばがーさぬ おー
かーじ／かじ	かーじ／かじ 〈たびに〉 【例】やーんかい
かーきー	かーきー 〈指切りげんまん〉 【例】うふっ
かーたー	かーたー 〈偏った、〜のような〉 【例】ちゅ
かーみー くー	かーみー くー 〈⻲の甲羅〉 【例】かーみ
かーみな くー	かーみな くー 〈べっ甲〉 【例】んかしぇ
かーちー	かーちー 〈夏至〉 【例】かーちーぬ くろ
かーらちゅん	かーらちゅん 〈乾く〉【活】かーらちゃん、
がーなー	がーなー 〈たんこぶ〉 【例】がーなー い
かーぶちー	かーぶちー 〈ミカンの一種〉 【例】かーぶ
かーぶやー	かーぶやー 〈コウモリ〉 【例】ゆる な
かいん	かいん 〈借りる〉【活】かたん、からん、かて
かいん	かいん 〈苅る〉【活】かたん、からん、かてぃ
かかいん	かかいん 〈世話になる、かかる〉【活】かか
かーみ	かーみ 〈甕〉 【例】「みーとぅんだー かーみ
かーみー	かーみー 〈⻲〉
かかい でー	かかい でー 〈粘り強さ〉 【例】なまぬ 
かきあーし むん	かきあーし むん〈間にあわせ用品〉 【例】
かかいん	かかいん 〈詰め寄る、引っかかる〉【活】かか
かかじーん	かかじーん 〈かじる〉【活】かかじたん、か
かきーん	かきーん 〈掛ける〉【活】かきたん、かきら
かき えー	かき えー 〈掛け合い〉 【例】んかしぇー
かかわい	かかわい 〈かかわり〉 【例】なーふぁとぅ 
かき むち	かき むち 〈掛け持ち〉 【例】ありくり 
かき じゃー	かき じゃー 〈吊るし鈎〉 【例】くーさ
かかん	かかん 〈下裳〉 【例】どぅぢぬん かかぬん
かきあーいん	かきあーいん 〈間に合う〉【活】かきあーた
かきーん	かきーん 〈賭ける〉【活】かきたん、かきら
かきあーすん	かきあーすん 〈間に合わす〉【活】かきあ
かぎーん	かぎーん 〈欠席する〉【活】かぎたん、かぎら
かくじ	かくじ 〈下顎全体〉 【例】ちらぬ しちゃむ
かきむん	かきむん 〈欠けたもの〉 【例】かきまかえー
かく	かく 〈癌、難病〉 【例】あれー さき ぬみ
かくすん	かくすん 〈（他に知られないように）隠す〉
がく ぶり	がく ぶり 〈学問以外は何も知らない人〉
かくい	かくい 〈囲い、垣根〉 【例】あかばなーぬ 
かくぐ すん	かくぐ すん 〈大切にしまい込む〉【活】〜
かくびち	かくびち 〈とても好いもの、おいしいもの、
かくむん	かくむん 〈囲む〉 【例】うほーくぬ っち
かくり ぶし	かくり ぶし 〈人前ではその気配を見せな
かげーいん	かげーいん 〈支配する〉【活】かげーたん、か
かさかさー	かさかさー 〈乾燥したさま、ごわごわしたさ
かし	かし 〈粕〉 【例】とーふぬかし いりちゃー
かさぎーん	かさぎーん 〈妊娠する〉【活】かさぎたん、か
かじ	かじ 〈風〉 【例】じゅーぐゎちぬ うふかじぇ
かさぎらすん	かさぎらすん 〈妊娠させる〉【活】かさぎら
かさばいん	かさばいん 〈重なる〉【活】かさばたん、か
かじ かたか	かじ かたか 〈風除け〉 【例】んかしぬ 
かじ ふち	かじ ふち 〈強風、暴風〉 【例】あちゃー、
かじ ふち あーけーじゅー	かじ ふち あーけーじゅー 〈暴風の前
かさびーん	かさびーん 〈重ねる〉【活】かさびたん、かさ
かじ まーい	かじ まーい 〈旋風、突風〉 【例】にんぐ
かじ ちり あびー	かじ ちり あびー 〈首筋が切れるほどの
かじ まやー	かじ まやー 〈かざぐるま、97 歳の生年祝
かじ まやー	かじ まやー 〈交差点〉 【例】かじまやー
かじ まやー ぎー	かじ まやー ぎー〈クチナシ〉 【例】か
かじ っわーら	かじ っわーら 〈風上〉 【例】かじっわー
かじ	かじ 〈数〉 【例】うちなーぐちさーに てぃ
かじ かじぬ	かじ かじぬ 〈たくさんの〉 【例】なー
かじ ならん	かじ ならん 〈取るに足らない〉 【例】か
かじ	かじ 〈舵〉 【例】はーりーすーぶんぢぇー 
かじ	かじ 〈筋、繊維〉 【例】かじぬ うふさる 
かしー	かしー 〈応援、援助〉 【例】かしーんかえー
かじみーん	かじみーん 〈大事にしまう〉【活】かじみた
かしがー	かしがー 〈麻布〉 【例】んかしぇー めり
かじみ むん	かじみ むん 〈秘蔵品〉 【例】くぬ けー
かしかき	かしかき 〈かせ掛け〉 【例】かしかきんで
かじゃ	かじゃ 〈臭い〉 【例】きぶしぬ かじゃ す
かしちー	かしちー 〈おこわ〉 【例】かしちーや か
かじゃい	かじゃい 〈飾り〉 【例】そーぐゎちぬ か
かしてぃら	かしてぃら 〈かまぼこの一種〉 【例】かし
かじゃい たてぃーん	かじゃい たてぃーん〈飾りたてる〉【活】〜
がじゃん	がじゃん 〈蚊〉 【例】がじゃんくぇー（蚊
がじまる	がじまる 〈がじゅまる〉 【例】くぬ がじ
かじゅーいん	かじゅーいん 〈数える〉【活】かじゅーたん、
かた あがい	かた あがい 〈半煮え〉 【例】くぬ むし
かしら	かしら 〈⻑、頭〉 【例】やーぬ かしらー 
かた	かた 〈肩〉 【例】あちゃーまでぃねー しー 
かた うでぃ	かた うでぃ 〈協力者〉 【例】っちょー 
かた うむい	かた うむい 〈片思い〉 【例】いーじまは
かた うや	かた うや 〈片親〉 【例】いくさをぅてぃ
かた かき	かた かき 〈不公平〉 【例】てぃーだん 
かた かきーん	かた かきーん 〈兼業する〉【活】〜かきた
かた	かた 〈形、型〉 【例】わらびぬ くろー ゐ
かた	かた 〈方向、方角〉 【例】すいぐしくから 
かた かしら	かた かしら 〈片髪、成人男子の髪型〉
かた	かた 〈片〉
かた ぐー	かた ぐー 〈片方〉 【例】しーさーぬ か
かた ちんし	かた ちんし 〈片ひざ〉 【例】んかしから
かた ぐー まんちゃー	かた ぐー まんちゃー 〈片チンバ〉
かた くくる	かた くくる 〈ひとまずの安心〉 【例】く
かたでぃー	かたでぃー 〈片手〉【活】かた ふぃさ〈片
かた くち われー	かた くち われー 〈微笑み〉 【例】あ
かた どぅー	かた どぅー 〈半身〉 【例】っちゅぬ 
かた げーな	かた げーな 〈片腕〉 【例】ぐじゅーかた
かた ばい	かた ばい 〈肩の盛りあがり〉 【例】てぃ
かた じー	かた じー 〈一方に片寄ること〉 【例】う
かた びーち	かた びーち 〈片ひいき〉 【例】っくゎ
かた しみ	かた しみ 〈片隅〉 【例】わったー まや
かた ぶい	かた ぶい 〈片降り（通り雨や片時雨とも異
かた ちみ がにぐゎー	かた ちみ がにぐゎー 〈潮まねき〉
かた みち	かた みち 〈片道〉 【例】みち のーちょ
かた わき	かた わき 〈不公平な配分〉 【例】ゆくぬ
かたじきーん	かたじきーん 〈片付ける〉【活】かたじきた
かたいん	かたいん 〈語る〉【活】かたたん、かたらん、
かたか	かたか 〈避け、除け〉 【例】わったー やー
かたち	かたち 〈敵〉 【例】どぅーがってぃーとぅか
かたか すん	かたか すん 〈さえぎる〉【活】〜さん、〜さ
かたち	かたち 〈姿〉 【例】をぅどぅいぬ しんしー
かたちき	かたちき 〈型染め〉 【例】びんがたー か
かたか みち	かたか みち 〈人目につかない道〉 【例】
がたがたー すん	がたがたー すん 〈震える〉【活】〜さ
かたはら	かたはら 〈傍ら、そば〉 【例】くぬ いよー
かたじー すん	かたじー すん 〈傾く〉【活】〜さん、〜さ
かたはら っんぶー	かたはら っんぶー 〈てんぷらの一種〉
かたばる	かたばる 〈干潟〉 【例】あーしぬ かたばる
かたふぃら むん／かたふぁー	かたふぃら むん／かたふぁー 〈肢
かたみ あちねー	かたみ あちねー 〈行商人〉 【例】かたん
かたまいん	かたまいん 〈つまる、ふさがる〉【活】かた
かたみ	かたみ 〈契り〉 【例】にーびち いーびなぎ
かたみーん	かたみーん 〈濃くする〉【活】かたみたん、か
かたいん	かたいん 〈語る〉【活】かたたん、かたらん、
かたみ	かたみ 〈形見〉 【例】くぬ しゅむちぇー 
かたらいん	かたらいん 〈仲間に入れる〉【活】かたらた
かたみーん	かたみーん 〈担ぐ、背負う〉【活】かたみた
かたれー／い かたれー	かたれー／い かたれー 〈仲間になるこ
かたんきーん	かたんきーん 〈傾ける〉【活】かたんきた
かち〜	かち〜〈掻き〜〉
かち くじーん	かち くじーん 〈ほじくり回す〉【活】〜く
かち しがいん	かち しがいん 〈すがりつく〉【活】〜しが
かたんちゅん	かたんちゅん 〈傾く〉【活】かたんちゃん、
かち ほーいん	かち ほーいん 〈散らかす〉【活】〜ほーた
かたんち ばい	かたんち ばい 〈恥ずかしくて顔をそむけ
かち みんぐゎすん	かち みんぐゎすん 〈かき乱す〉【活】〜み
かちゃーすん	かちゃーすん 〈かき混ぜる〉【活】かちゃー
かち	かち 〈働き、反復〉 【例】ゆーじゅかち し
かちゃーしー	かちゃーしー 〈テンポの速い三線の曲、乱
かちゃむん	かちゃむん 〈ひっかく〉【活】かちゃだん、か
かちゃんくゎーすん	かちゃんくゎーすん〈盛んにひっかく〉【活】
かちゅん	かちゅん 〈書く〉【活】かちゃん、かかん、か
かち いりーん	かち いりーん 〈書き入れる〉【活】〜いっ
かち ちき	かち ちき 〈文書〉 【例】あぬ かちちけ
かちゅん	かちゅん 〈かく〉【活】かちゃん、かかん、か
かちみーん	かちみーん 〈捕まえる〉【活】かちみたん、か
かちみ んそーれー	かちみ んそーれー〈⻤ごっこ〉 【例】か
かちゅん	かちゅん 〈増築する〉【活】かちゃん、かか
かちゅん	かちゅん 〈勝つ、すぐれる〉【活】かっちゃ
かっちかむん	かっちかむん 〈ひっつかむ〉【活】かっちか
がってぃん すん	がってぃん すん 〈賛成する、納得する、
がっぱい	がっぱい 〈一部がとび出している頭〉 【例】
かぢゃでぃふー	かぢゃでぃふー 〈かぎやで風〉 【例】う
かてぃーん	かてぃーん 〈一緒にする、おかずにする〉【活】
かちゅー	かちゅー 〈かつお〉 【例】かちゅーゆー 
かぢり	かぢり 〈限り、限定、期限〉 【例】じのー
かてぃ むん	かてぃ むん 〈おかず〉 【例】っんみぶし
かてーむん	かてーむん 〈困ったこと／者〉 【例】うん
かってぃー	かってぃー 〈勝手〉 【例】あまぬ とぅじ
かなーすん	かなーすん 〈噛む〉【活】かなーちゃん、か
かないん	かないん 〈叶う、達者である〉【活】かなたん、
かにーん	かにーん 〈遮る〉【活】かにたん、かにらん、
かなぎーん	かなぎーん 〈まくしあげる〉【活】かなぎた
〜がなしー	〜がなしー 〈最高の尊称〉 【例】うてぃん
かなみ	かなみ 〈要〉 【例】なーちゃー ちぶる や
かにてぃ	かにてぃ 〈以前〉 【例】かにてぃからぬ う
かぬち ぼー	かぬち ぼー 〈雄綱と雌綱を抜き通す棒〉
かなみ	かなみ 〈挨拶（交際上の要）〉 【例】ちゃー
かねーらすん	かねーらすん 〈かなえるように仕向ける〉
かに	かに 〈規範、常識〉 【例】とぅし とぅいね
かば かじゃ	かば かじゃ 〈芳香〉 【例】あんし か
かまじし	かまじし 〈無愛想〉 【例】あんし かまじ
がふぁさー	がふぁさー 〈強情者〉
がふぁ みかすん	がふぁ みかすん 〈ごつんと打つ〉【活】〜
かま	かま 〈かまど〉 【例】んかしぇー まぎいし
がま	がま 〈洞窟〉 【例】うちなーぬ がまぬ な
かまじぇー	かまじぇー 〈こおろぎ〉 【例】あち ない
かまち	かまち 〈頭の卑語、（釘・鎌の柄・鍬の柄の）
かまらさー	かまらさー 〈気難しい者〉 【例】あれー 
がまく	がまく 〈腰〉 【例】はちゃー がまく（蜂の
かまじー	かまじー 〈麻袋〉 【例】はる さーぬ すー
かまんた	かまんた 〈大釜の蓋〉 【例】しんめー なー
かみ	かみ 〈神〉 【例】かみうすりー しぇー、む
かみ あしゃぎ	かみ あしゃぎ 〈村の神を祭ってある建物〉
かみ だーり／かみ がかい	かみ だーり／かみ がかい 〈神がかり〉
かみ にげー	かみ にげー 〈神頼み〉 【例】っちゅにん
かみらりーん	かみらりーん 〈胃けいれんで苦しむ〉【活】
かむいん	かむいん 〈かまう、干渉する、世話する〉【活】
かみーん	かみーん 〈頭に乗せて運ぶ、おしいただく、
かみ あちねー さー	かみ あちねー さー 〈商品を頭に乗せて
かむん	かむん 〈食べる〉【活】かだん、かまん、かでぃ
かみ さし	かみ さし 〈男性用のかんざし〉 【例】う
かやーすん	かやーすん 〈持ち運ぶ〉【活】かやーちゃん、
かみ はんすん	かみ はんすん〈食べ損なう〉【活】〜はんち
から〜	から〜〈からっぽ、中味のない〉
から ぢゃー	から ぢゃー 〈茶請けなしの茶〉 【例】い
かみ ぶらーり	かみ ぶらーり 〈栄養失調〉 【例】いくさ
から ふぃさ	から ふぃさ 〈裸足〉 【例】なまー から
かめーいん	かめーいん 〈拾う、捜し求める〉【活】かめ
から ふに	から ふに 〈骸骨〉 【例】いくさから な
かや ぶち やー	かや ぶち やー 〈茅葺きの家〉 【例】
から ゆか	から ゆか 〈板の床〉 【例】んかしぇー 
がらさー、がらし	がらさー、がらし 〈カラス〉 【例】が
がら	がら 〈殻、空〉 【例】なーぬ あまくまんかえ
から〜	から〜〈干、乾〉
から がーき	から がーき 〈干上がること〉 【例】あま
からじ	からじ 〈髪〉 【例】【活】からじぎー（髪の
からじ くぇー	からじ くぇー 〈カミキリムシ〉 【例】か
から じゅすい	から じゅすい 〈乾拭き〉 【例】しゅむち
からじ ぶちかー	からじ ぶちかー 〈髪の毛の散らかってい
からいん	からいん 〈飼う〉 【例】しかいん からて
からすー	からすー 〈塩辛〉 【例】くぬ からすーや
からからー	からからー 〈酒の容器〉 【例】とーりてぃ
からすん	からすん 〈貸す〉【活】からちゃん、からさ
からすん	からすん 〈枯らす〉【活】からちゃん、からさ
かり いちゃ	かり いちゃ 〈スルメ〉 【例】かりいち
からみちゅん	からみちゅん 〈からみつく〉【活】からみち
かりゆし	かりゆし 〈めでたいこと〉 【例】かりー ゆ
から むん	から むん 〈辛いもの〉 【例】どぅく か
からうぃーばち すん	からうぃーばち すん 〈吐き気を催し
がる むん	がる むん 〈軽い物〉 【参】がっさん（軽
かる わじゃ	かる わじゃ 〈軽い仕事〉 【例】くぬ 
かりー	かりー 〈嘉例、縁起が良いこと〉 【例】た
かわいん	かわいん 〈変わる〉【活】かわたん、かわら
かわい	かわい 〈変わり、代わり〉 【例】やーんから
かわい ぐとぅ	かわい ぐとぅ 〈めったにあり得ないこと〉
かわい むん	かわい むん 〈変人〉 【例】エジソン や
かん	かん 〈勘〉 【例】うぬ くとぅば てぃーち
かんげーいん	かんげーいん 〈考える、世話する〉【活】か
がんしなー	がんしなー 〈（頭にのせて運ぶために物の下
かん ちげー	かん ちげー 〈勘違い〉 【例】っやーが 
かんじゃー やー	かんじゃー やー 〈鍛冶屋〉 【例】ん
かん	かん 〈こう〉 【例】あぎじゃびよー。かん 
がんじゅー	がんじゅー 〈頑丈〉 【例】がんじゅーむん
がんどぅいん	がんどぅいん 〈元気がなくなっている〉【活】
かんすい	かんすい 〈カミソリ〉 【例】わったーが 
かんとぅ	かんとぅ 〈髪の卑語〉 【例】どぅく かじ
かんとぅ むしーん	かんとぅ むしーん 〈髪をむしる〉【活】〜
かん すん	かん すん 〈こうする〉【活】〜さん、〜さ
かんない	かんない 〈雷〉 【例】かんないぬ ないね
かんぬー	かんぬー 〈肝要〉 【例】うやふぁーふじか
かんぢゅん	かんぢゅん 〈被る〉【活】かんたん、かんだ
かんしーん	かんしーん 〈被せる〉【活】かんしたん、か
かんぬ むし	かんぬ むし 〈癇の虫〉 【例】ゆーる 
がんまり	がんまり 〈いたずら、いじくりまわし〉 【例】
きー	きー 〈木〉 【例】いったー やーぬ なーや 
きー くさ	きー くさ〈木草、植物〉 【例】なーや き
きー じーふぁー	きー じーふぁー 〈木製かんざし〉 【例】
きー じぇーくー	きー じぇーくー 〈大工〉 【例】なまー 
きー じょー	きー じょー 〈木の門〉 【例】やーぬ じ
きー うーし	きー うーし 〈木臼〉 【例】きーうーしと
きー ぢり	きー ぢり 〈木切れ〉 【例】やちっんむ 
きー かし	きー かし 〈木屑、おがくず〉 【例】あみ
きーぬ しん	きーぬ しん 〈木の芯〉 【例】くぬ まー
きー ぶり だちゃー すん	きー ぶり だちゃー すん 〈鳥肌
きーぬ また	きーぬ また 〈木の股〉 【例】うちなーを
きー びさー	きー びさー 〈竹馬〉 【例】わらび そー
きー まっくゎ	きー まっくゎ 〈木枕〉 【例】んかしぇー
きー まー	きー まー 〈毛深い者〉 【例】きーまーと
きー むっくー	きー むっくー 〈つぼみ〉 【例】きーむっ
きーん	きーん 〈蹴る〉【活】きっちゃん、きらん、き
きーうい/ういぐゎー	きーうい/ういぐゎー 〈きゅうり〉 【例】なーふぁをぅてー とぅんじーじゅーしー う
ぎーたー	ぎーたー 〈片足〉 【参】かたふぃさ。
きじむなー	きじむなー 〈木の精〉 【例】きじむなーぬ
きぶし かじゃ	きぶし かじゃ 〈煙臭さ〉 【例】がじゃ
きらま	きらま 〈慶良間〉 【例】っちゅぬ くとー 
ぎぢゃー	ぎぢゃー 〈意地の悪い女〉 【例】ぎぢゃー
きぢゃーすん	きぢゃーすん 〈かき混ぜる、かき回す〉【活】
きぢゅん	きぢゅん 〈混ぜる、撹拌する、中傷する〉【活】
きっちゃき	きっちゃき 〈つまずき〉 【例】「ぬーが 
きり〜	きり〜〈蹴り〜〉
きり くゎーすん	きり くゎーすん 〈蹴りあげる〉【活】〜く
きり けーらすん	きり けーらすん 〈蹴り返す〉【活】〜けー
きぶいん	きぶいん 〈煙る〉【活】きぶたん、きぶらん、
きり とぅばすん	きり とぅばすん 〈蹴り飛ばす〉【活】〜と
きりりん ばんばん	きりりん ばんばん 〈取っ組み合いのけ
くいけーし	くいけーし 〈繰り返し〉 【例】っやーや 
くー ぐすい	くー ぐすい 〈粉薬〉 【例】くーぐすえー
くいじ	くいじ 〈恋路〉 【例】っちゅぬ くいじんか
くー	くー 〈籠〉 【例】なまー しぇーならんしが、
くいまーすん	くいまーすん 〈やりくりする〉 【例】あ
くー	くー 〈甲〉 【例】かーみぬ くーやか とぅ
くー	くー 〈コツ〉 【例】がに とぅったい、たく
くー	くー 〈穴〉 【例】わらび そーいに「なーびな
くー すん	くー すん 〈繕う〉【活】くーちゃん、くー
ぐー	ぐー 〈連れ、仲間〉【活】ゆいぬ むん（同類）
くー	くー 〈粉〉 【例】てぃんぷらー すくとぅ 
くー〜	くー〜〈小〉 【参】くーさん（小さい）からの
くー われー	くー われー 〈クスッと笑うこと〉 【例】
くー あちさ	くー あちさ 〈小暑〉 【例】くー あちさ
くーいん	くーいん 〈噛みつく〉【活】くーたん、くーら
くー いゆ	くー いゆ 〈鯉〉 【例】くーいよー んー
くーさ い	くーさ い 〈幼いころ〉【活】＝くーさる 
くー てーん	くー てーん 〈少し〉 【例】ちむ いふぃ
くー にー すん	くー   にー   すん 〈小 さ く 切 っ て 煮 る〉
くー もーい すん	くー もーい すん 〈小躍りする〉【活】〜
くー やー	くー やー 〈噛みつく者〉 【例】みみだい
くーいん	くーいん 〈請う〉【活】くーたん、くーらん、
くー やー	くー やー 〈嫁のもらい手〉 【例】っやー
くーいん	くーいん 〈閉じる〉【活】くーたん、くーら
くーが	くーが 〈卵〉 【例】ほーとー くーが たー
くーしぇー	くーしぇー 〈手落ち〉 【例】あれー ぬー
くーくぇー すん	くーくぇー すん 〈後悔する〉【活】〜さ
くーす	くーす 〈古酒〉 【例】くーそー ちゃっさ 
くーすん	くーすん 〈壊す〉【活】くーちゃん、くーさ
くーが ふぁーふぁー	くーが ふぁーふぁー 〈卵焼き〉 【例】
くーが ぐる	くーが ぐる 〈卵の殻〉 【例】はーちっう
くーぢ	くーぢ 〈公儀、公事〉
くーぢ ぐとぅ	くーぢ ぐとぅ 〈訴訟沙汰、公務〉 【例】
くーぢ むち	くーぢ むち 〈公費持ち〉 【例】あれー 
くーぎー	くーぎー 〈陰毛〉 【例】うぃきがぬちゃーや
くーとぅー	くーとぅー 〈〜以外〉 【例】やなむん ん
くーしー むん	くーしー むん 〈貧乏者〉 【例】いった
くーぶ	くーぶ 〈昆布〉 【例】うさんみうじゅーんか
くーとー	くーとー 〈公平〉 【例】ありが するくと
ぐーに	ぐーに 〈びっこ〉 【例】ぐーに／ねーぐ っ
くーりーん	くーりーん 〈崩れる〉【活】くーりたん、く
くーり じぇーうぇー	くーり じぇーうぇー 〈災い転じて福とな
くーばー	くーばー 〈クモ〉 【例】っちゅぬ いっちゃ
くーるー まーしぇー	くーるー まーしぇー 〈コマ回しの遊
くがた	くがた 〈こちら側〉 【例】っやーや ふどぅ
くがとー	くがとー 〈こんな遠方〉【活】うがとー〈そん
くーび	くーび 〈ぐみ〉 【例】くーび かみーが ち
くがに いーびなぎー	くがに いーびなぎー 〈金の指輪〉【活】
くくち	くくち 〈心地、気分〉 【例】わさわさーっし
くがに じーふぁー	くがに じーふぁー 〈金のかんざし〉
くがに じぇーく	くがに じぇーく 〈金細工職人〉【活】か
くがにー	くがにー 〈ミカンの一種〉 【例】くがにーぬ
くくぬ たい	くくぬ たい 〈九人〉 【例】ちゅい、たい、
くがらすん	くがらすん 〈焦がす〉【活】くがらちゃん、く
くくぬ とぅ ぐんじゅー	くくぬ とぅ ぐんじゅー 〈49〉【例】かじぬ ゆみかたー、てぃー、たー、みー、
くがりーん	くがりーん 〈焦がれる〉【活】くがりたん、く
くくむいん	くくむいん 〈つぼみを持っている〉【活】く
くくいん	くくいん 〈結ぶ、まとめる〉【活】くくたん、
くくむい	くくむい 〈つぼみ〉 【例】わんねー あて
くくる	くくる 〈心〉 【例】なさきぬ ねーん っち
くくむん	くくむん 〈口の中に含む〉【活】くくだん、く
くくますん	くくますん 〈口の中に含ませる〉【活】くく
くくる がきーん	くくる がきーん 〈心がける〉【活】〜がき
くげー	くげー 〈交流、交際〉 【例】なーふぁとぅ 
くくらき	くくらき 〈胸やけ〉 【例】どぅく やーさぬ、
くげー じん	くげー じん 〈交際費〉 【例】そーぐゎち
くくりーん	くくりーん 〈注意する〉【活】くくりたん、く
くげー ぢん	くげー ぢん 〈訪問着〉 【例】あきまどぅ
くさ	くさ 〈雑草〉 【例】わーが おーふぁ っう
くさー	くさー 〈後ろ〉 【例】ふーろー、んかしぇー
くさ ぶっくぃーん	くさ ぶっくぃーん 〈ませる〉【活】〜ぶ
くさ ぶっくゎー	くさ ぶっくゎー 〈ませた子〉 【例】くさ
くさいん	くさいん 〈まとめる〉【活】くさたん、くさら
くさい	くさい 〈まとめ〉 【例】やーぐさえー をぅ
くさてぃ	くさてぃ 〈つっかい棒、頼り、夫〉 【例】「っ
くさ むにー	くさ むにー 〈ませたもの言い〉 【例】む
くさぢゅん	くさぢゅん 〈包丁の刃を直角に当てて皮を
くさくさー すん	くさくさー すん 〈憤慨する〉【活】〜さ
くさぶっくぃーん	くさぶっくぃーん 〈ませる〉【活】くさぶ
くさみちゅん	くさみちゅん 〈腹を立てる〉【活】くさみ
くし	くし 〈欠点〉 【例】くしぬ ねーらん っち
くさみち あびー	くさみち あびー 〈つっけんどんな声〉
くじ	くじ 〈籤、クジ〉 【例】っちゅんかえー く
くさりーん	くさりーん 〈（生ものが）腐れる〉【活】くさ
くしーん	くしーん 〈着せる〉【活】くしたん、くしら
くじーん	くじーん 〈ほじくる〉【活】くじたん、くじら
くさらー	くさらー 〈腐れたもの〉 【例】いちゅび 
くし	くし 〈腰〉 【例】っやーん いふぇー くし 
くしがき	くしがき 〈頼りにすること、鼻にかけること〉
くじすん	くじすん 〈ごちそうに箸をつける、崩す〉【活】
くしち	くしち 〈戸籍〉 【例】っくゎ なしーねー、
ぐしち	ぐしち 〈すすき〉 【例】じゅーぐやーねー 
くす	くす 〈糞〉 【例】「くす くぇー」や やなむ
くじゅ	くじゅ 〈去年〉 【例】くじゅぬ うふしがり
くし でー	くし でー 〈腰力〉 【例】とぅし とぅい
くし ながに	くし ながに 〈背中〉 【例】くしながに 
ぐすぐす	ぐすぐす 〈半煮えの状態〉 【例】くぬ っ
くすい	くすい 〈薬〉 【例】をぅたとーらー にんぢ
くじりーん	くじりーん 〈崩れる〉【活】くじりたん、く
くすい でー	くすい でー 〈薬代〉 【例】くすいやー
くしれーいん	くしれーいん 〈解体する、屠殺する〉【活】
くたすん	くたすん 〈朽ちさせる〉【活】くたちゃん、く
ぐすーよー	ぐすーよー 〈皆様〉 【例】ぐすーよー が
くだすん	くだすん 〈下痢する〉 【例】わったー や
くす ぐぇー	くす ぐぇー 〈下肥え〉 【例】なまー 
くす ちり ばい	くす ちり ばい 〈一目散に走ること〉
くたちち	くたちち 〈先月〉 【例】わったー みーや
くす ふぃりー	くす ふぃりー 〈下痢〉 【例】なまどぅ
くだみーん	くだみーん 〈踏みにじる〉【活】くだみたん、
くたんでぃーん	くたんでぃーん 〈疲れる〉【活】くたんで
ぐそー	ぐそー 〈あの世〉 【例】うやふぁーふじぬ 
くだーき	くだーき 〈この高さ〉 【例】「いったー な
くたんでぃ のーし	くたんでぃ のーし〈疲れ直し〉 【例】に
くち	くち 〈語、ことば、口〉 【例】やまとぅぐち
くち がんすい	くち がんすい 〈口達者〉 【例】くちがん
くち ぐし	くち ぐし 〈口癖〉 【例】わんねー いち
くち かじ	くち かじ 〈口数〉 【例】うぃなごー あ
くち ぐとぅ	くち ぐとぅ 〈言い争い〉 【例】っちゅぬ
くち からじ	くち からじ 〈口も頭も疲れること〉 【例】
くち ぐふぁー	くち ぐふぁー 〈毒舌家〉 【例】あれー
くちぬ めー	くちぬ めー 〈一人食べていくだけの稼ぎ〉
くち ざんしん	くち ざんしん 〈口で三線をまねること〉
くち しば	くち しば 〈悪いうわさ〉【活】くちなん 
くちぬ っわーび	くちぬ っわーび 〈口先〉 【例】ありが 
くち のーし	くち のーし 〈口直し〉 【例】んぢゃむん
くち ふぃんとー	くち ふぃんとー 〈口答え〉 【例】っちゅ
くち しる	くち しる 〈口の中の唾液〉 【例】みーぬ
くち ぶーち	くち ぶーち 〈ほら吹き〉【活】くち ぶー
くち ぢゅくい	くち ぢゅくい 〈口に物を入れること〉
くち	くち 〈遺骨〉
くち どぅみ	くち どぅみ 〈口止め〉 【例】っちゅにん
くち うーちー	くち うーちー 〈遺骨の移転〉 【例】くち
くち うんちけー／みくち うんちけ	くち うんちけー／みくち うんちけ
ー	ー 〈遺骨のお招き〉 【例】みーばか ちゅく
くとぅ	くとぅ 〈こと、物事〉 【例】ちかぐろー ぬ
くち （かじ）	くち （かじ）〈東風〉 【例】なちぇー 
くちゅぐいん	くちゅぐいん 〈くすぐる〉 【例】ぐなわ
くとぅ かちゅん	くとぅ かちゅん 〈足りずに不自由する〉
くとぅ さび	くとぅ さび 〈災い〉 【例】やくどぅし
くちゅび	くちゅび 〈イボ〉 【例】くちゅべー やーち
くっくるーうー	くっくるーうー 〈雄鶏の鳴き声〉 【例】
くっぴ／くっさ	くっぴ／くっさ 〈これっぽち〉【活】＝く
くとぅ―	くとぅ―〈琴〉 【例】くとぅー ならいぶさ
くとぅし	くとぅし 〈今年〉 【例】くとぅしぇー ダ
くてーいん	くてーいん 〈堪える〉【活】くてーたん、く
くとぅば	くとぅば 〈ことば、地域語〉 【例】なーふ
くとぅば かじ	くとぅば かじ 〈ことば数〉 【例】あかん
くとぅばぬ うー	くとぅばぬ うー 〈ことばの綾〉 【例】あ
くとぅぶち	くとぅぶち 〈寿〉 【例】うゆえーをぅてぃ
くなーすん	くなーすん 〈踏みつける〉【活】くなーちゃ
くなすん	くなすん 〈消化する、耕す〉【活】くなちゃん、
くとぅゆしーん	くとぅゆしーん 〈口実をもうける〉【活】
くとぅわいん	くとぅわいん 〈断る〉【活】くとぅわたん、
くなびーん	くなびーん 〈比べる〉【活】くなびたん、く
くに	くに 〈村、町、国〉 【例】ゑーまー うちな
くとぅわき	くとぅわき 〈訳を言って断ること〉
くとぅわき すん	くとぅわき すん 〈陳謝する〉【活】〜さ
ぐとーん	ぐとーん 〈ようだ〉 【例】はなぬ ぐとぅ
くねーいん	くねーいん 〈こらえる、許す〉【活】くねー
くにちょーでー	くにちょーでー 〈血縁関係のない似ている
くねーだ んし	くねーだ んし 〈近頃、最近〉 【例】く
くにぶ	くにぶ 〈ミカン〉 【例】うちなーぬ くに
くば	くば 〈クバ〉 【例】くばぬ ふぁーさーに く
くにんだ	くにんだ 〈久米村〉 【例】くにんだんかえ
くばめーすん	くばめーすん 〈節約する〉【活】くばめーち
くぬむん	くぬむん 〈考案する〉【活】くぬだん、くぬま
くび	くび 〈首、襟〉 【例】ちんぬ くび のーしぇ
くぬ ゆちゃ	くぬ ゆちゃ 〈この歳〉 【例】わんが 
くび がー	くび がー 〈うなじ〉 【例】あぬ っちょ
くぬ ぐるんし	くぬ ぐるんし 〈この頃〉 【例】やーぬ
くび	くび 〈壁〉 【例】あまくまぬ やーぬ くび
くふぁ ばにー すん	くふぁ ばにー すん 〈きっぱり拒絶す
くふぃな	くふぃな 〈この大きさの、こんなに大きな〉
くふぁいん	くふぁいん 〈固くなる、仲が悪くなる〉【活】
くぶしみ	くぶしみ 〈イカの一種〉 【例】くぶしめー
くふぁ でーさー	くふぁ でーさー 〈クファーデーサー〉
くぶん	くぶん 〈窪地〉 【例】わったーやーや くぶ
くまいん	くまいん 〈家にこもる〉【活】くまたん、くま
くふぁ ぱっちらー	くふぁ ぱっちらー 〈固まるさま〉 【例】
くま〜	くま〜〈細かな〉 【参】くまさん（つつましい）
くま きー	くま きー 〈細かい切れっ端〉 【例】わら
くみ んちゅん	くみ んちゅん 〈汲み入れる〉【活】〜んち
くま ぐまーぬ くとぅ	くま ぐまーぬ くとぅ 〈詳細な事柄〉
ぐま〜	ぐま〜〈小さな〉 【参】ぐまさん（小さい）か
ぐま ぢけーぐゎー	ぐま ぢけーぐゎー 〈小銭〉 【例】まぎ
くむい	くむい 〈池〉 【例】りゅーたんぬ くむいん
くま むてぃ	くま むてぃ 〈この側〉 【例】くまむてぃ
くむいん	くむいん 〈曇る〉 【例】がらすぬ くむと
くむぢゃー	くむぢゃー 〈あばたの者〉 【例】にくんぬ
くみ	くみ 〈米〉 【例】くみぬ ちりとーくとぅ 
くむん	くむん 〈切り開く〉【活】くだん、くまん、く
くみーん	くみーん 〈押し込める〉【活】くみたん、くみ
くむん	くむん 〈組む、履く、編む〉【活】くだん、く
くみ	くみ 〈組み〉 【例】じゅーばくぬ ちゅくみ
くみ をぅどぅい	くみ をぅどぅい 〈組踊り〉 【例】くみを
くみ んちゅん	くみ んちゅん 〈踏み入れる〉【活】〜んち
くめーきーん	くめーきーん 〈倹約する、丁寧にする、く
くらー	くらー 〈雀〉 【例】くらーや うふやーにん
くらし がた	くらし がた 〈暮らし方、生計〉 【例】ふ
くらじょーりーん	くらじょーりーん 〈薄暗くなる〉【活】く
くらしん	くらしん 〈真っ暗〉 【例】くらしんみー 
くるー	くるー 〈黒、黒いもの、反対派〉 【例】くぬ
くらすん	くらすん 〈暮らす〉【活】くらちゃん、くらさ
ぐるくん	ぐるくん 〈たかさご〉 【例】ぐるくのー 
ぐり	ぐり 〈沈殿物、粕〉 【例】ちゃーぬ／んーす
くるすん	くるすん 〈懲らしめる、（動物を）殺す〉【活】
くりー まやー	くりー まやー 〈さかりのついた猫〉
ぐりー	ぐりー 〈お辞儀〉 【例】っちゅぬ めーから
くるち	くるち 〈黒木〉 【例】くるちぇー さんしん
くり かー	くり かー 〈この辺り〉 【例】くりかーん
くるばすん	くるばすん 〈転ばす〉【活】くるばちゃん、く
〜くる	〜くる 〈自身で〉 【例】わんくる（私自身で）、
くるばしぇー	くるばしぇー 〈遊びの一種〉 【例】かた
くるぶん	くるぶん 〈転ぶ〉【活】くるだん、くるばん、
くん たばいん	くん たばいん 〈強く縛る〉【活】〜たばた
くるべー	くるべー 〈黒カビ〉 【例】ぬいぢき しぇ
くるむん	くるむん 〈黒ずむ〉【活】くるだん、くるむ
くん ちかいん	くん ちかいん 〈こき使う〉【活】〜ちかた
くるん げーい	くるん げーい 〈衣替え〉 【例】うちな
くんぐとーるー	くんぐとーるー 〈これと似たもの〉 【例】
くんぐゎち ちくじゃき	くんぐゎち ちくじゃき 〈9 月 9 日の菊酒〉 【例】くんぐゎち ちくじゃけー く
くん〜	くん〜〈強く、勢いよく〉
くん ちきーん	くん ちきーん 〈踏みつける〉【活】〜ちき
くん ちゃーすん	くん ちゃーすん 〈かき消す〉【活】〜ちゃ
くん ちゃきーん	くん ちゃきーん 〈（水、湯を）ひっかけ
くん しばいん	くん しばいん 〈強く縛る〉【活】〜しばた
くん しみーん	くん しみーん 〈強く締める〉【活】〜しみ
くん のーすん	くん のーすん 〈持ち直す〉【活】〜のーち
くん ちゅーいん	くん ちゅーいん 〈強くなる、立って歩け
くん のーいん	くん のーいん 〈立ち直る〉【活】〜のーた
くん ぱいん	くん ぱいん 〈踏ん張る〉【活】〜ぱたん、〜
くん とーすん	くん とーすん 〈踏み倒す〉【活】〜とーち
くん とぅいん	くん とぅいん 〈横取りする〉【活】〜とぅ
くん はんすん	くん はんすん 〈踏み外す〉【活】〜はんち
くん ぬぢゅん	くん ぬぢゅん 〈追い越す〉【活】〜ぬぢゃ
くんじょー	くんじょー 〈悪い根性〉 【例】ありんかい
くんだ	くんだ 〈こむら〉 【例】ゆなか くんだあが
くんぢゃん	くんぢゃん 〈国頭〉 【例】くんぢゃんぬ 
くんち	くんち 〈元気、体力〉 【例】うちなーぬ な
くんぢ	くんぢ 〈紺地〉 【例】くがにーぬ しるっし
くんちーん	くんちーん 〈横切って近道をする〉【活】く
くんぢゅん	くんぢゅん 〈くびる、縛る、拘束する〉【活】
くんち うじにー	くんち うじにー 〈栄養食〉 【例】んー
くんぺん	くんぺん 〈焼き菓子の一種〉 【例】くんぺ
くんちゃー	くんちゃー 〈乞食〉 【例】くんちゃーぬ 
くんぴーん	くんぴーん 〈踏みつぶす〉【活】くんぴたん、
くんぴらかすん	くんぴらかすん 〈踏みつける〉【活】くん
ぐんぼー	ぐんぼー 〈ゴボウ〉 【例】ぐんぼー びさ
けー	けー 〈貝〉 【例】ぶらげーや けーぬ てぃー
けー／うけー	けー／うけー 〈粥〉 【例】んかしぇー 
げー	げー 〈反抗、口答え〉 【例】うや／しーじゃ
けー〜	けー〜〈さっと（する）、いつの間に（状態変
けー るー	けー るー 〈交換、交代〉 【例】あかーと
けー しぢゅん	け ー   し ぢ ゅ ん 〈す で に 死 ん で し ま う〉
けー とぅいん	けー とぅいん 〈ひったくる、横取りする〉
けーうち	けーうち 〈小皿〉 【例】うぬ あたい そ
けーすん	けーすん 〈返す、帰す、耕す〉【活】けーちゃ
けー まーい まーい すん	けー まーい まーい すん 〈廻って来
けーさー	けーさー 〈（何度も）くり返すこと〉 【例】
けーいん	けーいん 〈返る／帰る〉【活】けーたん、けー
けーいん	けーいん 〈換える〉【活】けーたん、けーら
けーし まー	けーし まー 〈裏返し〉 【例】っやーや 
けーし むどぅし	けーし むどぅし 〈おつり〉 【例】なー
けーな	けーな 〈腕〉 【例】っんぶむん むちぢゅー
けーりーん	けーりーん 〈ひっくり返る〉【活】けーった
けーりん くるびん すん	けーりん くるびん すん 〈転げ回る〉
けーん	けーん 〈〜回、度〉 【例】ちゅけーん（１回）、
げーん	げーん 〈魔除け〉 【例】ぐしち みーち た
けーらすん	けーらすん 〈ひっくり返す〉【活】けーらち
けんらー	けんらー 〈威張る者〉 【例】けんらーや 
けーらし くるばし すん	けーらし くるばし すん 〈ひっくり返
こーいむん	こーいむん 〈買い物〉 【例】うさきーぬ 
こーい むん さー	こーい むん さー 〈買い物をする人、買
こーいん ぐぇー	こーいん ぐぇー 〈買い食い〉 【例】なま
こーさー	こーさー 〈軽いげんこつ〉 【例】しんでぃ
こーがーきー	こーがーきー 〈頬かむり〉 【例】あまを
こーぐ	こーぐ 〈腰〉 【例】こーぐ ぬばち ゐら
こーじ	こーじ 〈カビ〉 【例】なちぬ あちさるばす
こーじん すん	こーじん すん 〈告げ口をする〉【活】〜さ
こーこーな むん	こーこーな むん 〈孝行者〉 【例】う
こーとぅ	こーとぅ 〈爪先、手の卑語〉 【例】うちな
こーる	こーる 〈香炉〉 【例】うちなーぐゆみぬ ち
こーれー ぐす	こーれー ぐす 〈唐辛子〉 【例】むぬ か
こーるー	こーるー 〈駒〉 【例】んかしぬ うぃきがわ
くゎー、っくゎ	くゎー、っくゎ 〈過ぎ〉 【例】ちゃぬよ
くゎーすん	くゎーすん 〈（口紅などを）塗り込む、（香水
〜ぐゎー	〜ぐゎー 〈指小辞〉 【例】あみぐゎーぬ 
くゎーぎ	くゎーぎ 〈桑の木〉 【例】くゎーぎぬ み
くゎじ	くゎじ 〈火事〉 【例】んかしぇー きーやー
くゎーすん	くゎーすん 〈食わせる〉【活】くゎーちゃん、
〜ぐゎー しぇー	〜ぐゎー しぇー 〈〜ごっこ〉 【例】いく
くゎーすん	くゎーすん 〈挟み込む〉【活】くゎーちゃん、
くゎっくぃーん	くゎっくぃーん 〈隠れる〉【活】くゎっく
くゎーりーん	くゎーりーん 〈食われる〉【活】くゎーった
くゎいん	くゎいん 〈喰らう〉【活】くゎたん、くゎー
くゎっくぃ ぐとぅ	くゎっくぃ ぐとぅ 〈隠し事〉 【例】わ
くゎっくぃん とーれー	くゎっくぃん とーれー 〈かくれんぼ〉
〜ぐゎち	〜ぐゎち 〈〜月（がつ）〉 【例】そーぐゎち
くゎっくゎすん	くゎっくゎすん 〈（見えないように）隠す〉
くゎっちー	くゎっちー 〈ごちそう〉 【例】くゎっちー
くゎびー すん	くゎびー すん 〈贅沢する〉【活】〜さん、〜
くゎふー	くゎふー 〈果報、幸運〉 【例】どぅーくる
くゎふーし／かふーし	くゎふーし／かふーし 〈（目上から目下
くゎんさち	くゎんさち 〈鑑札、免許〉 【例】しんしー
ぐゎんす	ぐゎんす 〈元祖〉 【例】ぐゎんすむちゃーや
くゎんそー	くゎんそー 〈萱草〉 【例】みーぐふぁいっ
っくゎ	っくゎ 〈子〉 【例】っくゎぬちゃー（子ども
っくゎ なし みち	っくゎ なし みち 〈子の産み方〉 【例】
っくゎ なしみ やー	っくゎ なしみ やー 〈助産婦〉 【例】
っくゎ びーちゃー	っくゎ びーちゃー〈子びいきの者〉 【例】
っくゎ うむやー	っくゎ うむやー 〈子煩悩の者〉 【例】す
っくゎ むちゃー	っくゎ むちゃー 〈子持ち〉 【例】どぅー
っくゎぐゎー	っくゎぐゎー 〈動物の赤ちゃん〉 【例】ぱ
っくゎ むやー	っくゎ むやー 〈子守り〉 【例】んかしぇ
っくゎ なさー	っくゎ なさー 〈お産の軽い人〉 【例】っ
くぃー	くぃー 〈声、消息〉 【例】くぃー ちちゅん。
くぃー ちゃーすん	くぃー ちゃーすん 〈喰いしばる〉【活】〜
くぃー ちちゅん	くぃー ちちゅん 〈噛み切る〉【活】〜ちち
くぃー がーい	くぃー がーい 〈声変わり〉 【例】くぃー
くぃー がらー	くぃー がらー 〈声がかれた者〉 【例】な
くぃー わいん	くぃー わいん 〈噛んで割る〉【活】〜わた
くぃー ぢゅくり	くぃー ぢゅくり 〈咳払い〉
くぃーじきーん	くぃーじきーん 〈背負い込む〉【活】くぃ
くぃーみちーん	くぃーみちーん 〈閉め切る〉【活】くぃーみ
くぃー〜	くぃー〜〈喰い〜〉
くぃー くぃむん	くぃー くぃむん 〈喰い込む〉【活】くぃ
くぃーん、くぃーゆん	くぃーん、くぃーゆん 〈越える〉【活】
くぃーん、くぃゆん	くぃーん、くぃゆん 〈くれる〉【活】く
くぇー	くぇー 〈肥料〉 【例】いったー ごーやーや
くぇー ぢらー	くぇー ぢらー 〈食ってばかりで仕事をし
くぇーいん	くぇーいん 〈太る〉【活】くぇーたん、くぇ
くぇー ぶー	くぇー ぶー 〈食い運〉 【例】なま くゎ
くぇー ぶたー／くぇー たー／くぇ	くぇー ぶたー／くぇー たー／くぇ
くぇーち	くぇーち 〈全快〉 【例】ながわじゃれーっし
ー やー	ー やー 〈デブ〉 【例】くぇーぶたーんか
ぐぇったい	ぐぇったい 〈泥んこ〉 【例】あまー ぐぇ
くぇー	くぇー 〈喰らい〉 【参】「くゎ＋い」からの
くぇー くち	くぇー くち 〈食費〉 【例】てぃまー い
さー	さー 〈霊力〉
さー だか っんまり	さー だか っんまり 〈霊力のある者〉
さー ぐさみち	さー ぐさみち 〈少しばかり怒ること〉
さー まき	さー まき〈霊力負け〉 【例】かかいむん 
さー ゆー	さー ゆー 〈白湯〉 【例】くすえー さー
さー	さー 〈差〉 【例】っやーとぅ わんとー いく
さー	さー 〈すこしばかり〉
さーい	さーい 〈つわり、跳ね返り〉 【例】っくゎ 
さー ふーふー	さー ふーふー 〈ほろ酔い加減〉 【例】さ
さーい まき	さーい まき 〈つわり負け〉 【例】さーい
さーいん	さーいん 〈触る〉【活】さーたん、さーらん、
さーし	さーし 〈錠〉 【例】さーしぇー さーしぬっ
さーじ	さーじ 〈鉢巻き〉 【例】はじみてぃぬ あ
さーらー／さーなー	さーらー／さーなー 〈逆立ち〉 【例】ま
さーるー	さーるー 〈猿／人真似をする者〉 【例】さー
さーれー さんぐゎん	さーれー さんぐゎん 〈危うきに近寄
さーじゃー	さーじゃー 〈サギ〉 【例】まんこぬ さー
さーたー	さーたー 〈砂糖〉 【例】うちなーをぅてー
さいた っちゅ／むん	さいた っちゅ／むん 〈変な人／もの〉
さか	さか 〈逆〉 【例】やないみ んーちん、いめ
さーたー あんだぎー	さーたー あんだぎー 〈砂糖てんぷら〉
さか どぅい すん	さか どぅい すん 〈素直にとらない〉
さがい てぃーだ	さがい てぃーだ 〈夕日〉 【例】さがいて
さか むにー	さか むにー 〈不合理なことを言うこと〉
さがい いゆ	さがい いゆ 〈新鮮ではない魚〉 【例】さ
さか まちげー	さか まちげー 〈逆まつげ〉 【例】さかま
さか みじ	さか みじ 〈逆流する水〉 【例】なーんか
さか んけー	さか んけー 〈旅の帰りを迎えること〉
さがい	さがい 〈低地〉 【例】わったー やーや さ
さがい ごーい	さがい ごーい 〈掛けで買うこと〉 【例】
さかな やー	さかな やー 〈料亭〉 【例】さかなやーや
さき	さき 〈酒〉 【例】さきんかいどぅ ぬまっと
さき がく	さき がく 〈酒飲み過ぎでおこる病気〉
さがいん	さがいん 〈下がる〉【活】さがたん、さがら
さき がち	さき がち 〈二日酔い〉 【例】さきがち 
さき くぇー	さき くぇー 〈酒飲み〉【活】さき ぬまー
さき じょーぐ	さき じょーぐ 〈酒好き〉【活】さき じょ
さき やー	さき やー 〈酒屋〉 【例】さきやーや さ
さき うぃー	さき うぃー 〈酒酔い〉 【例】さきうぃー
さく	さく 〈量、程度、ほど〉 【例】ぬーぐとぅに
さきーん	さきーん 〈裂ける、割ける〉【活】さきたん、
さぎーん	さぎーん 〈吊るす、下げる〉【活】さぎたん、
さくいん	さくいん 〈引っ掻く〉【活】さくたん、さくら
さく ふぃら	さく ふぃら 〈急な上り坂〉 【例】んかし
さぐいん	さぐいん 〈探る〉【活】さぐたん、さぐらん、
さく ぐみ	さく ぐみ 〈うるち米〉 【例】まるふぃー
さきむい	さきむい 〈結納〉 【例】さきむいねー、く
さく むち	さく むち 〈癇癪持ち〉 【例】どぅく さ
さじらすん	さじらすん 〈細くする〉【活】さじらちゃん、
さくら	さくら 〈寒緋桜〉 【例】さくらー ちゅらさ
さくら いる	さくら いる 〈桜色〉 【例】おんせんから
さけー みー	さけー みー 〈境界、境目〉 【例】くまが
さけーいん	さけーいん 〈栄える〉 【例】あぬ っちゅ
さじゃかいん	さじゃかいん 〈授かる〉【活】さじゃかたん、
さすん	さすん 〈刺す、挿す、差す〉【活】さちゃん、さ
さし いーび	さし いーび 〈人差し指〉 【例】うちなー
さげーすん	さげーすん 〈探す〉【活】さげーちゃん、さ
さし ぐすい	さし ぐすい 〈目薬〉 【例】みーぬ あか
さし んちゅん	さし んちゅん 〈差し込む〉【活】〜んちゃ
さち ない し が むぬー	さち ない し が むぬー 〈早い者勝
さた	さた 〈評判、音信〉 【例】ちぬざ ある っ
さち	さち 〈先端〉 【例】はーいぬ さちっし ち
さち ばい	さち ばい 〈先駆け〉 【例】うぃなごー 
さち まーい	さち まーい 〈抜け駆け〉 【例】っうぇん
さち	さち 〈先、将来〉 【例】っちょー あとぅさち
さち ぐち	さち ぐち〈手始め〉 【例】ちゅーぬ しく
さち だち すん	さち だち すん 〈先導する〉【活】〜さ
さち でぃー っんぢゃすん	さち でぃー っんぢゃすん 〈先手を打
さち	さち 〈札〉 【例】しんゐんさちぇー ちゃっ
さちゅん	さちゅん 〈裂く〉【活】さちゃん、さかん、さ
さちゅん	さちゅん 〈咲く〉【活】さちゃん、さかん、さ
さち どぅめーい／さち どぅみ	さち どぅめーい／さち どぅみ 〈先
さち ちりーん	さち ちりーん 〈咲き誇っている〉【活】〜
さに	さに 〈種〉 【例】なーんかい しちしちぬ 
さっこーび	さっこーび 〈しゃっくり〉 【例】さっこー
さば	さば 〈ぞうり〉 【例】んかしぇー あしぢゃ
さっくぃー	さっくぃー 〈咳〉 【例】さっくぃー しー
さってぃむ	さってぃむ 〈さても〉 【例】ふぃるまさど
さばきーん	さばきーん 〈片付ける〉【活】さばきたん、さ
さばちゅん	さばちゅん 〈さばく、髪をすく、薪を割る〉
さてぃ	さてぃ 〈さて〉 【例】さてぃ、ぬーから は
さとぅ	さとぅ 〈（芝居や歌劇の中での）彼氏〉 【例】
さばち	さばち 〈櫛、くし〉 【例】はたらちゃー う
さばに	さばに 〈サバニ〉 【例】いちまぬん、ゆなぬ
さとぅいん	さとぅいん 〈さとる〉【活】さとぅたん、さと
さび	さび 〈災い〉 【例】くとぅばー てぃーちから
さまいん	さまいん 〈冷める〉【活】さまたん、さまら
さび	さび 〈錆〉 【例】うみぬ はんたーや すー
さますん	さますん 〈冷ます〉【活】さまちゃん、さまさ
さびさびーとぅ そーん	さびさびーとぅ そーん 〈人っ気がな
さまたげー	さまたげー 〈妨げ〉 【例】っちゅぬ さま
さみーん	さみーん 〈覚める〉【活】さみたん、さみら
さますん	さますん 〈醒す〉【活】さまちゃん、さまさ
さび じる	さび じる〈貧弱なおつゆ〉 【例】ぢっちゅ
さふー	さふー 〈作法〉 【例】うやぬ むんならー
さら	さら 〈皿〉 【例】うちなーぐちしぇー、さら
さら〜	さら〜〈まったくの〉 【例】さらみーむん（ま
さぼーりーん	さぼーりーん 〈荒れ果てる〉【活】さぼーり
さら ばんじ	さら ばんじ 〈最盛期、絶頂期〉 【例】る
されーいん	されーいん 〈浚う〉【活】されーたん、され
さら みー むん	さら みー むん 〈真新しいもの〉 【例】
さら まくとぅ	さら まくとぅ 〈馬鹿正直、お人好し〉【活】
さわいん	さわいん 〈体に障る〉【活】さわたん、さわ
さわぢゅん	さわぢゅん 〈騒ぐ〉【活】さわぢゃん、さわ
さん	さん 〈お産〉 【例】さんぬ っんぶさる っち
さわい	さわい 〈障り、病気＝やんめー〉 【例】たん
さらすん	さらすん 〈色が抜ける〉【活】さらちゃん、さ
さん	さん 〈魔除け〉 【例】ぐしちぬ ふぁー と
さんぐゎち あしび	さんぐゎち あしび 〈三月遊び（旧暦の
さんさなー	さんさなー 〈クマゼミ〉 【例】「さんさなー
さんじんそー	さんじんそー 〈占い師〉 【例】さんじん
さんしん	さんしん 〈三線〉 【例】さんぐゎちゆっか
さんにん	さんにん 〈月桃〉 【例】さんにんがーさっ
さんみん	さんみん 〈計算、判断〉 【例】くれー さ
しー	しー 〈元気、精〉 【例】しー ぬぎとーる 
しー	しー 〈岩〉 【例】なーんかい まぎしー う
しー	しー 〈負債〉 【例】しーとぅ やんめーや 
しー	しー 〈背丈、身丈〉 【例】わかどぅえー しし
しー いみやー	しー いみやー 〈借金取り〉 【例】しわー
しー ばれー	しー ばれー 〈負債払い〉 【例】やーぬ 
しー	しー 〈「すん」という動詞語幹の名詞化、す (ん)＋い〉 【例】「語は少なくとも２拍を保持しな
しー くたんでぃ	しー くたんでぃ 〈過労〉 【例】ぬーにん
しー	しー 〈巣〉 【例】ほーとぅぬ しーや くー
しー うわいん	しー うわいん 〈やり終える〉【活】〜うわ
しー かきーん	しー かきーん 〈やり始める〉【活】〜かき
しー のーすん	しー のーすん 〈やり直す〉【活】〜のーち
しー がねー	しー がねー 〈意地っ張りになること〉
しー なりーん	しー なりーん 〈し慣れる〉【活】〜なりた
しー けーすん	しー けーすん 〈やり返す〉【活】〜けーち
しー はな	しー はな 〈できたて〉 【例】むぬん ち
しー やんぢゅん	しー やんぢゅん 〈しくじる〉【活】〜やん
しーしー はーはー すん	しーしー はーはー すん 〈ふうふう言
しー やんぢ （ぐとぅ）	しー やんぢ （ぐとぅ）〈やりそこない
しー どーり	しー どーり 〈過労で倒れること〉 【例】
しー わじゃ	しー わじゃ 〈行為、行い〉 【例】「あれ
じー	じー 〈字〉 【例】くれー たー じー やが？
しー なし	しー なし 〈仕上げ〉 【例】さびむん や
しーん、しゆん	しーん、しゆん 〈知る〉【活】しっちゃん、
しーん、しゆん	しーん、しゆん 〈こする、さする〉【活】し
しー ぶん	しー ぶん 〈おまけ〉 【例】ちゃー あま
しーきーん	しーきーん 〈押しやる〉【活】しーきたん、し
しーいん／しーゆん	しーいん／しーゆん 〈（いったん煮たも
しーぐ	しーぐ 〈小刀、ナイフ〉 【例】しーぐん し
しーくい めーくい すん	しーくい めーくい すん 〈ふらふ
しー らすん	しー らすん 〈腐らす〉【活】しーらちゃん、
しー かじゃ	しー かじゃ 〈腐れた匂い〉 【例】うぬ 
しーいん／しーゆん	しーいん／しーゆん 〈おまけとして添え
しーくむん	しーくむん 〈炊き置きする〉【活】しーくだ
じーぐい	じーぐい 〈不平〉 【例】あれー じーぐふ
しーし	しーし 〈煤〉 【例】っちゅぬ しまん やー
じーぐい すん	じーぐい すん 〈不平不満をいう〉【活】〜
じーぐい ひゃーぐい	じーぐい ひゃーぐい 〈不平不満〉 【例】
しーくゎ	しーくゎ 〈スイカ〉 【例】うちなーをぅてー
じーし がーみ	じーし がーみ 〈厨子甕〉 【例】くれー
しーじゃ しんでー	しーじゃ しんでー 〈年⻑順〉 【例】う
しーちゅん	しーちゅん 〈つめて寄る〉【活】しーちゃん、
しー くゎーさー	しー くゎーさー 〈シークヮーサー〉
しーちゃー くゎーしぇー	しーちゃー くゎーしぇー 〈押し合い〉
じーなー	じーなー 〈蛍〉 【例】じーなーや ちゅら
しーし	しーし 〈獅子〉 【例】まちりねー かりー 
じーぬー	じーぬー 〈芸能〉 【例】じーぬー むちゃ
しーむん	しーむん 〈吸い物〉 【例】ふぃーじーぬ 
しーっうぃー	しーっうぃー 〈手豆〉 【例】わらび そー
しーよー	しーよー 〈仕方〉 【例】っやー しーよー
しーら	しーら 〈病み気、苦しみ〉 【例】っくゎ な
しーばい	しーばい 〈小便〉 【例】ふぃーく ないね
しーばい ぶくる	しーばい ぶくる 〈膀胱〉 【例】しー
じーふぁー	じーふぁー 〈かんざし〉 【例】まるけーて
しー いっぺー すん	しー いっぺー すん 〈精一杯する〉
しーん、しゆん	しーん、しゆん 〈知る〉【活】しっちゃん、
しーん、しゆん	しーん、しゆん 〈擦る〉【活】したん、し
しーみー	しーみー 〈清明祭〉 【例】うちなーぐゆみ
しぇー	しぇー 〈バッタ〉 【例】しぇーぬ うすまさ
しぇーべー	しぇーべー 〈おせっかい〉 【例】しぇーべ
しがいん	しがいん 〈すがる〉【活】しがたん、しがら
しぇーく	しぇーく 〈大工〉 【例】いしじぇーこー て
しぇーうぇー	しぇーうぇー 〈幸せ〉 【例】しぇーうぇー
しかきーん	しかきーん 〈仕掛ける〉【活】しかきたん、し
しぇーじゅく	しぇーじゅく 〈催促〉 【例】からちぇーる
しぇーち	しぇーち 〈才知〉 【例】しぇーちぇー い
しかすん	しかすん 〈なだめる、だます〉【活】しかち
しぇんするー	しぇんするー 〈糸とんぼ〉 【例】しぇん
しかしー まーしー すん	しかしー まーしー すん 〈なだめすか
しかー（ぐゎー）、しかぼー	しかー（ぐゎー）、しかぼー 〈臆病者〉
しがりーん	しがりーん 〈お金を工面する〉【活】しがっ
しかしかー すん	しかしかー すん 〈びくびくする〉【活】〜
しかた	しかた 〈仕様〉 【例】っやーが まちぇーる
しがり なみ	しがり なみ 〈津波〉 【例】ねーん う
しかむん	しかむん 〈怖じけずく〉【活】しかだん、しか
しかん すん	しかん すん 〈嫌う〉【活】〜さん、〜さん、〜
しかみー ぐるぐる すん	しかみー ぐるぐる すん 〈びくびくす
じかん	じかん 〈時間〉 【例】ぬち かぎり はたら
しきん	しきん 〈世間〉 【例】みっちゃい すりれ
しかますん	しかますん 〈脅かす〉【活】しかまちゃん、し
しきーん	しきーん 〈食べ物を煮る用意をする、米を
しか むどぅち	しか むどぅち 〈鹿もどき〉 【例】しか
しくむん	しくむん 〈仕込む〉【活】しくだん、しくま
しぎーん	しぎーん 〈すげる、差し込む〉【活】しぎた
しこーいん	しこーいん 〈準備する〉【活】しこーたん、し
しき むん	しき むん 〈敷物〉 【例】ふぃーく なたく
しこーい むこーい	しこーい むこーい 〈準備〉 【例】うゆ
しし	しし 〈肉〉 【例】ししぇー なまじさーどぅ
しきん	しきん 〈世間〉 【例】みっちゃいから しき
しくち	しくち 〈仕事〉 【例】しくちん さんぐとぅ
しじ	しじ 〈筋〉 【例】っやーが いーる くとー
しじ	しじ 〈神霊〉 【例】「しじ、うしじ、うしじめ
しじみ かち	しじみ かち 〈整頓〉 【例】しじみかちぬ
しじむん	しじむん 〈沈む〉【活】しじだん、しじまん、
しじか	しじか 〈静か〉 【例】ぐまわらびんちゃーぬ
ししだま	ししだま 〈じゅずだま〉 【例】ししだまぎー
しじゃま	しじゃま 〈態度〉 【例】あれー しじゃま
したい	したい 〈したり〉 【例】ゆー でぃかちぇー
しだすん	しだすん 〈ふ化させる〉 【例】とぅいぬ 
じしち	じしち 〈時節〉 【例】しだく なてぃ、ゐー
しだすん	しだすん 〈化粧する〉 【例】いちいちまで
ししぢゅん	ししぢゅん 〈すすぐ〉【活】ししぢゃん、しし
ししみーん	ししみーん 〈進める、勧める〉【活】ししみ
しだむん	しだむん 〈涼む〉【活】しだだん、しだまん、
しじみーん	しじみーん 〈片付ける、整頓する〉【活】し
しだ かじ	しだ かじ 〈涼風〉 【例】しむちち ない
しち	しち 〈好き〉 【例】たーんかい やてぃん し
しちきーん	しちきーん 〈備え付ける〉【活】しちきたん、
しぢーん	しぢーん 〈過ぎる、やつれる〉【活】しぢた
しちぐゎち そーぐゎち	しちぐゎち そーぐゎち 〈盆と正月〉
しちきーん	しちきーん 〈やっつける、しつける〉【活】
しちゅん	しちゅん 〈敷く〉【活】しちゃん、しかん、し
じち	じち 〈本当〉 【例】じちぇー よー。（実はね
しちゃ	しちゃ 〈下〉 【例】うっちんとぅーっし し
しちゃ しば	しちゃ しば〈下唇〉【活】っわー しば〈上
しちき	しちき 〈しつけ〉 【例】なまぬ うやぬち
しちゃ だくまー	しちゃ だくまー 〈こっそりたくらむ者〉
しちゃ でぃー	しちゃ でぃー 〈贈収賄〉 【例】うてぃ
しったい ないん	しったい ないん 〈濡れる〉【活】〜なた
しったい かーたい ないん	しったい かーたい ないん 〈びしょぬ
しちゃ ぬい	しちゃ ぬい 〈下塗り〉 【例】やー ふち
しったい でぃー	しったい でぃー 〈濡れた手〉 【例】しっ
しちゃ ばー	しちゃ ばー 〈下⻭〉 【例】わらびぬ は
しちゃ ばー	しちゃ ばー 〈下葉〉 【例】をぅーじぬ 
しったい ぢん	しったい ぢん 〈濡れ着〉 【例】なまぬ
しちゃ ばい	しちゃ ばい 〈下方にだらだらと後をひい
しちゃ ふぃぢ	しちゃ ふぃぢ 〈あごひげ〉 【例】あぬ
しっぷいん	しっぷいん 〈吸い出す〉【活】しっぷたん、し
しっぴー ないん	しっぴー ないん 〈ぺっしゃんこになる〉
しっぴりーん	しっぴりーん 〈ぺしゃんこになる〉【活】し
しったいん	しったいん 〈濡れる〉【活】しったたん、し
しっぴらー	しっぴらー 〈ぺしゃんこのもの〉 【例】く
しでぃ がら	しでぃ がら 〈抜け殻〉 【例】なちぇー 
しっぴらかすん	しっぴらかすん 〈潰す〉【活】しっぴらかち
しでー よーい	しでー よーい 〈衰弱すること〉 【例】
しとぅ	しとぅ 〈姑〉 【例】にーびち しーねー、う
してぃーん	してぃーん 〈捨てる〉【活】してぃたん、し
しな むん	しな むん 〈品物〉 【例】ぐままちやー 
してぃ ほーりーん	してぃ ほーりーん 〈粗末にする〉【活】〜
しでぃーん	しでぃーん 〈ふ化する〉【活】しでぃたん、し
しなさき	しなさき 〈なさけ、情愛、思いやり〉 【例】
しでぃ がふー	しでぃ がふー 〈感謝、おめでた〉 【例】
しに	しに 〈すね〉 【例】しに をぅーらりーん 
しぬん	しぬん 〈(事故で) 死ぬ、（動物が）死ぬ〉 【例】わったー いんぐゎーや しぢねーん。（僕ん
しに っちゅ	しに っちゅ 〈死人〉 【例】いくさをぅ
しぬぶん	しぬぶん 〈忍ぶ〉【活】しぬだん、しぬばん、
しば	しば 〈舌〉 【例】なまー しばぬ はぎとー
しに どぅくる	しに どぅくる 〈死に場所〉 【例】ゐん
しに やんぢゃー	しに やんぢゃー 〈死に損ない〉 【例】い
しに〜	しに〜〈すごく（うちなーやまとぅぐちの接頭
しば いる	しば いる 〈唇の色〉 【例】しばいるぬ 
しば かんちらかんちら すん	しば かんちらかんちら すん 〈舌がう
しばい	しばい 〈芝居〉 【例】こくりつげきじょーぬ
しぬぢゅん	しぬぢゅん 〈しのぐ〉【活】しぬぢゃん、し
しぴたいん	しぴたいん 〈しょんぼりする〉【活】しぴた
しぴたー	しぴたー 〈弱虫〉 【例】わらび そーいね
じふぃ、じっぴ	じふぃ、じっぴ 〈真偽〉 【例】むぬぐとぅ
しぶいん	しぶいん 〈絞る〉【活】しぶたん、しぶらん、
しぷいん	しぷいん 〈しゃぶる〉【活】しぷたん、しぷら
しぷ〜	しぷ〜〈粘り強い〉 【参】「しぷさん」からの
しぷー	しぷー 〈粘り強い者〉 【例】しぷーや しー
しぷー だき	しぷー だき 〈弾力性のある竹〉 【例】ち
しぶい	しぶい 〈冬瓜〉 【例】そーきじろー しぶい
じぶん	じぶん 〈時間〉 【例】じぶのー ちゃー 
しぷたいん	しぷたいん 〈湿る、だらしがない〉【活】し
しま	しま 〈地域〉 【例】うちなーぬ なーむらむら
しぷしぷ そーん	しぷしぷ そーん 〈じめじめしている、よ
しまー	しまー 〈島内産、島育ち〉 【例】しまーや 
しみーん	しみーん 〈させる〉【活】しみたん、しみら
しま	しま 〈相撲〉 【例】うちなーぬ しまー は
しみけーいん	しみけーいん 〈湿気る〉【活】しみけーた
しますん	しますん 〈済ます〉【活】しまちゃん、しまさ
しむ	しむ 〈台所〉 【例】むぬ かだらー しもー
しまり	しまり 〈戸締まり〉 【例】しまれー しー？
しみ	しみ 〈学問〉 【例】しめー しっち むのー
しむ	しむ 〈冷雨〉 【例】うちなーぬ さくらー し
しみーん	しみーん 〈締める〉【活】しみたん、しみら
しむ ちち	る）。しむ ちち 〈霜月、11 月〉 【例】しむちち
しみーん	しみーん 〈責める〉【活】しみたん、しみら
しむち	しむち 〈根性〉 【例】しむち わるー（根性
しむん	しむん 〈済む〉【活】しだん、しまん、しでぃ
じゃーふぇー	じゃーふぇー 〈始末におえないこと〉 【例】
じゃーふぇー てぃーふぇー	じゃーふぇー てぃーふぇー 〈悪さをさ
じゃまどぅいん	じゃまどぅいん 〈うろたえる〉【活】じゃ
しよー しじゃま	しよー しじゃま 〈やり方〉 【例】あれ
じゃーま	じゃーま 〈迷うこと〉 【例】やんばるぬ 
じゃー	じゃー 〈蛇〉 【例】うぃなぐぬ はてぃれー
じゃしち	じゃしち 〈部屋、寝床〉 【例】いったー や
じゃー	じゃー 〈座〉 【例】じゃー はねーきやーぬ
じゃっとぅー、うじゃっとぅー	じゃっとぅー、うじゃっとぅー 〈飾
じゃーがる	じゃーがる 〈粘土質の黒土〉 【例】「じゃ
じゃま	じゃま 〈様〉 【例】あれー っくゎ なち 
じゃんぬ いゆ	じゃんぬ いゆ 〈ジュゴン〉 【例】やんば
じゅーてー	じゅーてー 〈金銭のやりくり〉 【例】うぃ
じゅー	じゅー 〈尾、しっぽ〉 【例】ぬーぐとぅん 
じゅー むっかー、じゅー むっこー	じゅー むっかー、じゅー むっこー
じゅーるくにち	じゅーるくにち 〈旧暦の 1 月 16 日〉 【例】じゅーるくにちぇー ぐそーぬ そーぐゎち 
じゅーばく	じゅーばく 〈重箱〉 【例】しーみーねー 
じゅー ふい	じゅー ふい 〈しっぽ振り〉 【例】いんぬ
じゅーぐやー	じゅーぐやー 〈十五夜〉 【例】ちゅーや
〜じゅく	〜じゅく 〈〜にかかりっきり〉 【例】もー
じゅん	じゅん 〈正常〉 【例】あまぬ をぅとー め
じゅーしー	じゅーしー 〈炊き込みご飯〉 【例】じゅー
しぇーしん	しぇーしん 〈お代わり〉 【例】うほーく 
しぇーべー	しぇーべー 〈余計〉 【例】しぇーべー ぐ
しよー むよー	しよー むよー 〈いろいろな手段を講じる
じょー	じょー 〈門〉 【例】っうぃーぬ あやじょー
じょーふぃ	じょーふぃ 〈吉日〉 【例】じょーふぃねー
じょーふ	じょーふ 〈上布〉 【例】じょーふや じょ
じょーま	じょーま 〈一人前、標準〉 【例】じょーま
じょーさ	じょーさ 〈費用〉 【例】やー ふちゅる じ
じょー、ぐじょー	じょー、ぐじょー 〈手紙〉 【例】ゆー 
じょーじ	じょーじ 〈上手〉 【例】ぬー ちゅくらち
じょーぐー	じょーぐー 〈好き者〉 【例】さきじょーぐ
じょーのー、かねー	じょーのー、かねー 〈税金〉 【例】は
しらっくゎ	しらっくゎ 〈生後 6 ヶ月ぐらいの赤ん坊〉【例】あかんぐゎーや ふどぅいしんでー ちら
しわーし	しわーし 〈師走〉 【例】しわーし ないね
しる	しる 〈汁〉 【例】みーや ねーらん、しるび
しる ぢきー	しる ぢきー 〈汁かけご飯〉 【例】むぬぐ
しるー	しるー 〈白、白いもの、賛成派、与党〉 【例】
しるし	しるし 〈兆候〉 【例】でぃーぐぬ はなぬ 
しらー くさー	しらー くさー 〈前後左右、周囲〉 【例】
しらい	しらい 〈シロアリ〉 【例】しらいぬ わさわ
しらすん	しらすん 〈知らせる〉【活】しらちゃん、しら
しらびーん	しらびーん 〈調べる、検査する〉【活】しら
しわ	しわ 〈心配〉 【例】しわぐとぅぬ ねーん 
しわ さー	しわ さー 〈心配性の者〉 【例】かんげー
しらむん	しらむん 〈白む〉【活】しらだん、しらまん、
しらんちゅ すん	しらんちゅ すん 〈人見知りする〉【活】〜
じる	じる 〈どれ〉 【例】にちょーるー なとーく
しらんふーなー すん	しらんふーなー すん 〈知らんふりす
しん	しん 〈芯、本心〉 【例】うれー しんから 
しん	しん 〈味気〉 【例】さきびんぬ ふた みち
しりちゃーすん	しりちゃーすん 〈もみ消す〉【活】しりち
じん	じん 〈お金〉 【例】うっぴぐゎーぬ じんぐ
しりぬがーいん	しりぬがーいん 〈人になすりつけて逃れ
しりはぢゅん	しりはぢゅん 〈擦りむく〉【活】しりはぢ
じん いりやー	じん いりやー 〈財布〉 【例】じんいりや
じん もーきじゅく	じん もーきじゅく 〈金儲け〉 【例】じ
じん かじゃ すん	じん かじゃ すん 〈お金の臭いがする〉
しんか	しんか 〈仲間、グループ〉 【例】あれー む
じん かに	じん かに 〈お金〉【活】じんがに〈欲張り〉
しんぐぃーん	しんぐぃーん 〈曇る〉【活】しんぐぃたん、
じん してぃ ぐとぅ	じん してぃ ぐとぅ 〈お金を捨てるよう
じん てーし ぐとぅ	じん てーし ぐとぅ 〈お金を浪費するよ
じん ぢけー	じん ぢけー 〈金使い〉 【例】じんむちゃ
しんくち	しんくち 〈洗骨〉 【例】んかしぇー けー
しんしー めーさー	しんしー めーさー 〈先生におべっか使
しんじーん	しんじーん 〈煎じる〉【活】しんじたん、し
じん ぢまい	じん ぢまい 〈金詰まり〉 【例】じんぢま
しんじ むん	しんじ むん 〈煎じ汁〉【活】しんじ ぐす
しんだかすん	しんだかすん 〈滑らす〉 【例】やーぬ っ
じんぶん	じんぶん 〈知恵〉 【例】ぬー やてぃん 
しんたく すん	しんたく すん 〈洗濯する〉【活】〜さん、〜
じんぶん くさらー	じんぶん くさらー 〈知恵なし、バカ〉
しんちりーん	しんちりーん 〈澄み切る〉【活】しんちりた
じんぶん むちゃー	じんぶん むちゃー 〈知恵のある者〉【活】
しんでぃーん	しんでぃーん 〈滑る〉【活】しんでぃたん、
しんま	しんま 〈霊媒となって予言をすること〉 【例】
じんとー	じんとー 〈本当〉 【例】ありが いちょー
しんにん	しんにん 〈仙人〉 【例】しるふぃぢ たて
しんめー なーび	しんめー なーび 〈大きな鍋〉 【例】し
しん ふぃちゃぎ	しん ふぃちゃぎ 〈神経衰弱〉 【例】あ
すい	すい 〈首里〉 【例】うすがなしーめーぬ い
すいんちゅ	すいんちゅ 〈首里の人〉 【例】すいんちょ
すいん	すいん 〈剃る〉 【例】なげーさる やしみぬ
すー みじ	すー みじ 〈塩水、海水〉 【例】すーみじ
すいん	すいん 〈添う〉【活】すたん、すらん、すてぃ
すーぬ はな	すーぬ はな 〈清めの塩〉 【例】だびか
すー／あんまー	すー／あんまー 〈お父さん／あ⺟さん〉
すー	すー 〈潮、海水〉 【例】すーや くるすー 
すー わたい	すー わたい 〈浅瀬渡り〉 【例】すーぬ 
すーいん	すーいん 〈吸う〉【活】すーたん、すらん、す
すー ちかー	すー ちかー 〈豚肉の塩漬け〉 【例】「す
すーこー	すーこー 〈焼香〉 【例】すーこーや いちに
すーてぃーち	すーてぃーち 〈ソテツ〉 【例】あぐねー
すーじ	すーじ 〈路地〉 【例】わらび そーいに、が
すーてー	すーてー 〈所帯持ち〉 【例】うぃなごー や
すーじ	すーじ 〈祝い事〉 【例】うちなーんかえー 
すーじ じゃー	すーじ じゃー 〈祝宴の座〉 【例】んかし
すーてー わかやー	すーてー わかやー 〈所帯分かれ〉 【例】
すーねー	すーねー 〈酢味噌あえ〉 【例】んーすぬ 
すーぶ	すーぶ 〈勝負〉 【例】んかしぇー かーらを
すーまん ぼーすー	すーまん ぼーすー 〈梅雨、小満芒種〉
すーみ	すーみ 〈興味〉 【例】ふるむぬんかい すー
すがい	すがい 〈服装〉【活】すがい さー〈身なりを
すがすん	すがすん 〈風にあてる〉【活】すがちゃん、す
すーみ	すーみ 〈のぞき見〉 【例】すーみ そーん。
すーむん	すーむん 〈熱中している〉【活】すーだん、す
すがりーん	すがりーん 〈風にあたる〉【活】すがったん、
すーよー	すーよー 〈みんな〉 【例】なーだ すーよ
すーら	すーら 〈梢〉 【例】かじょーら のーする 
すぎーん	すぎーん 〈削げる〉【活】すぎたん、すぎらん、
すがいん	すがいん 〈支度する、装う〉【活】すがたん、
すく	すく 〈底〉 【例】うぃなぐうやぬ っくゎ 
すくちな むん	すくちな むん 〈ひょうきん者〉 【例】
すく	すく 〈きびなご〉 【例】すこー スクぬ ち
すくぶん	すくぶん 〈職分〉 【例】っちゅんかえー 
すく がらす	すく がらす 〈きびなごの塩辛〉 【例】す
すくむん	すくむん 〈すくむ、縮こまる〉【活】すくだ
すくいん	すくいん 〈救う〉 【例】くねーだ いさぬ
すくいん	すくいん 〈掬う〉【活】すくたん、すくらん、
すくんかー すん	すくんかー すん 〈縮み上がる〉【活】〜さ
すぐりーん	すぐりーん 〈優れる〉【活】すぐりたん、す
すぐいん	すぐいん 〈殴る、たたく〉【活】すぐたん、す
すぐり んぐゎ	すぐり んぐゎ 〈すぐれた子〉 【例】あま
すぐらー／すぐり むん／すぐりんち	すぐらー／すぐり むん／すぐりんち
ゅ	ゅ 〈優れ者〉 【例】あまぬ っくゎぬちゃー
すぐい けーらすん	すぐい けーらすん〈ひっぱたたく〉【活】〜
すじょー	すじょー 〈楽しみ〉 【例】じこー すじょ
すだち	すだち 〈育ち〉 【例】あまぬ うぃなぐんぐ
すじょー すん	すじょー すん 〈楽しむ〉【活】〜さん、〜さ
すす	すす 〈裾〉 【例】ちん のーさーんかい ち
すすいん	すすいん 〈拭いてきれいにする〉【活】すす
すそーん すん	すそーん すん 〈粗末にする〉【活】〜さ
すだてぃーん	すだてぃーん 〈育てる、養育する〉【活】す
すだてぃ みち	すだてぃ みち 〈育て方〉 【例】っくゎ 
すだてぃぬ うや	すだてぃぬ うや 〈育ての親〉 【例】なし
すっくぃー	すっくぃー 〈米を練って作った糊〉 【例】
すでぃ	すでぃ 〈袖〉 【例】なち やてぃん やきら
すでぃ ばか	すでぃ ばか 〈仮りの墓〉 【例】っんま
すだちゅん	すだちゅん 〈育つ〉【活】すだっちゃん、す
すとぅみてぃ／すてぃみてぃ／してぃみてぃ／ひてぃみてぃ	すとぅみてぃ／すてぃみてぃ／してぃみてぃ／ひてぃみてぃ 〈早朝〉
すびちゅん	すびちゅん 〈退かす〉【活】すびちゃん、す
すなわいん	すなわいん 〈充分にそろう〉【活】すなわた
すぬい	すぬい 〈もずく〉 【例】すぬえー あふぁむ
すみーん	すみーん 〈染める〉【活】すみたん、すみら
すむん	すむん 〈染まる〉【活】すだん、すまん、すで
すば	すば 〈そば〉 【例】うちなーんちゅんかい 
すみ むん	すみ むん 〈染め物〉 【例】すみむのー 
すば	すば 〈側、傍ら〉 【例】くらーぐゎーよー、っ
すば ふぃらー	すば ふぃらー 〈周辺〉 【例】ふてぃま
すみ やー	すみ やー 〈染め物屋〉【活】すーやー〈塩
すむち、しゅむち	すむち、しゅむち 〈書物、本〉 【例】く
すらーすん	すらーすん 〈揃える〉 【例】がっこーを
すりーん	すりーん 〈集まる〉 【例】ちゅーや すりー
すりー	すりー〈集まり〉 【例】すりー にんじゅ（出
すりー じゃー	すりー じゃー 〈集会所〉 【例】うとぅす
すんじーん	すんじーん 〈破れて痛む、損じる〉【活】す
すんちゅん	すんちゅん 〈引きずる〉【活】すんちゃん、す
すん	すん 〈損〉 【例】うさきーぬ じん はらて
すん かぶい すん	すん かぶい すん 〈商売で損をする〉
すん	すん 〈しみ〉 【例】ちぬんかい ちーぬ す
すん くゎいん	すん くゎいん 〈沁みる、凍みる、滲みる〉
すんち けーらすん	すんち けーらすん〈引きずり倒す〉【活】〜
〜すん 	〜すん  〈〜てしまう〉【活】〜さん、〜さん、〜
〜すん	〜すん 〈〜がる〉【活】〜さん、〜さん、〜っし
〜すん	〜すん 〈〜する〉【活】〜さん、〜さん、〜っし
そー	そー 〈竿〉 【例】んかしぇー だきさーに ち
そー	そー 〈性根、思慮〉 【例】そー いっち ゐ
そー ぬぎーん	そー ぬぎーん 〈うろたえる〉【活】〜ぬぎ
そー いらー／そー いり むん	そー いらー／そー いり むん 〈しっ
そーいん	そーいん 〈連れる〉【活】そーたん、そーら
そー〜	そー〜〈実の、本物の〉
そー うや	そー うや 〈実の親〉 【例】そーうや や
そー たまし	そー たまし 〈精魂〉 【例】そーたましぬ
そー なー	そー なー 〈実名〉 【例】んかしぇー そ
そー どぅくる	そー どぅくる 〈急所〉 【例】そーどぅく
そー ふりむん	そー ふりむん 〈まったくのバカ〉 【例】
そー ぬがー	そー ぬがー 〈おっちょこちょい、うっか
そー むん	そー むん 〈本物〉 【例】くぬ いーびな
そーき ぶに	そーき ぶに 〈肋骨〉 【例】んにぬ ふ
そー わらび	そー わらび 〈まったくの子ども〉 【例】
そー んぐゎ	そー んぐゎ 〈実子〉 【例】そーんぐゎぬ
そーがー しりー	そーがー しりー 〈ショウガのすりおろ
そーぐ	そーぐ 〈鉦〉 【例】なーふぁぬ うふちなふ
そーぐゎち	そーぐゎち 〈正月〉 【例】ちゅらぢん ち
そーぐゎち っわー	そーぐゎち っわー 〈正月用の豚〉 【例】
そーかん	そーかん 〈熱病〉 【例】んかしぇー みじぬ
そーぐゎち われー	そーぐゎち われー〈正月笑い〉 【例】そ
そーき	そーき 〈かご〉 【例】だきさーに あまっと
そーしち	そーしち 〈性質、性格〉 【例】あぬ っち
そーべー	そーべー 〈粗製品〉 【例】「やまとぅ そー
そーみー	そーみー 〈斜視〉 【例】いりがさー やん
そーみん ぷっとぅるー	そーみん ぷっとぅるー 〈素麺炒め〉
そーゆー	そーゆー 〈醤油〉 【例】そーゆーいりやー
そーみなー	そーみなー 〈メジロ〉 【例】んかしぇー 
た〜	た〜〈2〉
た くとぅ	た くとぅ 〈二言〉 【例】たくとー ねー
た なか	た なか 〈間、中間〉 【例】っうぇーきんち
た けーん	た けーん 〈二度〉 【例】たけーん ある
た ちち	た ちち 〈来月〉 【例】たちちぇー ぐん
た ちち	た ちち 〈2 ヶ月〉 【例】あたらさる っち
た とぅ	た とぅ 〈2 歳、2 年〉 【例】うぃきがし
た とぅーい	た とぅーい 〈二通り〉 【例】むぬぐとぅ
た また がき	た また がき 〈二股かけること〉 【例】
たー	たー 〈誰〉 【例】たー やらわん しむくとぅ
たー がな	たー がな〈誰か〉 【例】たーがな くり 
たー	たー 〈田〉
たー いゆ	たー いゆ 〈鮒、フナ〉 【例】たーいゆぬ
た とぅ ぐしー	た とぅ ぐしー 〈2 年おき〉 【例】たと
たー ぐしれー	たー ぐしれー 〈田植えの準備〉 【例】っ
たー ぶっくゎ	たー ぶっくゎ 〈田んぼ〉 【例】うーや
たー むぢ	たー むぢ 〈田芋のずいき〉 【例】んかし
たー っんむ	たー っんむ 〈田芋〉 【例】なままでー
だー／はー なー	だー／はー なー 〈おい、ねえ〉 【例】
たーくとぅ	たーくとぅ 〈うわごと〉 【例】どぅく に
たーち	たーち 〈2 つ〉
たーち すん	たーち すん 〈兼ねる〉【活】〜さん、〜さ
たーち まちゃー	の２件は私がやっておく）。たーち まちゃー 〈つむじが 2 つある者〉
たーち みしー	って。男の子であれば、勇敢な人になるって）。たーち みしー 〈2 歳違いの子を産むこと〉
たーち わい	たーち わい 〈二分〉 【例】かーらから 
たーぐ	たーぐ 〈水桶〉 【例】んかしぇー、あぐにを
たーまー	たーまー 〈⻤やんま〉 【例】うふかじぬ ち
だーぐ	だーぐ 〈だんご〉 【例】くるじゃーたー だ
たーび	たーび 〈足袋〉 【例】んかしぇー ゆかっち
〜たい	〜たい 〈〜人〉 【例】やーにんじょー いく
たーりー	たーりー 〈お父さん〉 【例】ゆかっちょー 
たいん	たいん 〈垂れる〉【活】たたん、たらん、たて
たーりーん、たーり すん	たーりーん、たーり すん 〈費やす〉
だいん	だいん 〈体がだるくなる、力がなくなる〉【活】
だりーん	だりーん 〈体がだるくなる〉【活】だりたん、
たりゆん	たりゆん 〈足りる〉【活】たりたん、たらー
たい	たい 〈2 人〉 【例】ちゅい（１人）、たい（２人）、みっちゃい（３人）、ゆったい（４人） や
たか ごーい	たか ごーい 〈高く買ってしまうこと〉
たか そー	たか そー 〈背の高い人〉 【例】でーじな
たうちー	たうちー 〈闘鶏〉 【例】あれー たうちー
たか	たか 〈鷹〉 【例】たかぬ もーれー がらし
たか〜	たか〜〈高〉
たか でぃー とぅやー	たか でぃー とぅやー 〈高利貸し〉
たか でー	たか でー 〈高価〉 【例】たかでー はら
たか ばしる	たか ばしる 〈高窓〉【活】とぅばしる〈雨
たか うっちゃき	たか うっちゃき 〈高値をふっかけること〉
たか ぶいん	たか ぶいん 〈偉そうに振る舞う〉【活】〜ぶ
たか うちゃぎ すん	たか うちゃぎ すん 〈偉そうにする〉
たか われー	たか われー 〈高笑い〉 【例】あれー ま
たかまーみ	たかまーみ 〈めだか〉 【例】たかまーめー
たき ぶん	たき ぶん 〈身分〉 【例】あぬ うかたー
だき	だき 〈竹〉 【例】んかしぇー やんばるだき
たからんぐゎ	たからんぐゎ 〈子宝〉 【例】にーびちっ
たきな むん	たきな むん 〈程度の知れた者〉 【例】あ
たかりーん	たかりーん 〈たかる〉【活】たかりたん、た
たき	たき 〈岳、山〉 【例】うちなーぐゆみぬ し
たくぶん	たくぶん 〈たたむ〉【活】たくだん、たくば
たくま	たくま 〈利口さ〉 【例】たくまぬ ちゅーさ
たき むい	たき むい 〈山、岳〉 【例】やんばろー 
たくむん	たくむん 〈たくらむ〉【活】たくだん、たくま
たき	たき 〈背丈〉 【例】なまぬ うぃなぐわらび
たげー	たげー 〈お互い〉 【例】なげー あっちょー
たげー ちげー すん	たげー ちげー すん 〈くい違う〉【活】〜
たげーに うーふー／いーひー す	たげーに うーふー／いーひー す
ん	ん 〈互いに敬語を使って／使わずに会話する〉
たぢらし けーさー	たぢらし けーさー 〈何度も煮返したも
たちゅん	たちゅん 〈立つ、経つ、断つ、発つ、嫁ぐ〉
たげーすん	たげーすん 〈耕す〉【活】たげーちゃん、た
たち	たち 〈辰〉 【例】たちぇー ふぇーむてぃあ
たちー まじくい	たちー まじくい 〈他血統の者〉 【例】
たぢーん	たぢーん 〈たぎる〉【活】たぢたん、たぢら
たぢらすん	たぢらすん 〈たぎらせる〉【活】たぢらちゃ
たち ぐりさ すん	たち ぐりさ すん 〈暮らしで苦労する〉
たち かんてぃー すん	たち かんてぃー すん 〈生活苦にあえ
だちびん	だちびん 〈酒瓶〉 【例】だちびんでぃ い
たち くんぱい すん	たち くんぱい すん 〈立ちっぱなしであ
たちふぁ	たちふぁ 〈立場〉 【例】ありが あねー 
たち ぢゅく	たち ぢゅく 〈生活〉 【例】なまー たち
だちゅん	だちゅん 〈抱く〉 【例】っくゎ／っんまが 
たち なち すん	たち なち すん 〈遠吠えする〉【活】〜さ
たち ぬち すん	たち ぬち すん 〈立ち退きする〉【活】〜
たち むい すん	たち   む い   すん 〈立 っ て 子 守 り す る〉
たち むどぅい すん	たち むどぅい すん 〈出戻る〉【活】〜
たてぃーん	たてぃーん 〈立てる、記入する〉【活】たて
たてぃけー いりけー すん	たてぃけー いりけー すん 〈何度
たっ〜	たっ〜〈動詞に付く強意の接頭辞〉 【例】たっ
たとぅい	たとぅい 〈例え〉 【例】たとぅい あん 
たっくゎーすん	たっくゎーすん 〈くっつける〉【活】たっく
たとぅれー	たとぅれー 〈例えば〉 【例】たとぅれー、
たっくゎいん	たっくゎいん〈くっつく、癒着する〉【活】た
たな	たな 〈棚〉 【例】すむち ならびーんち な
たっくゎいむっくゎい すん	たっくゎいむっくゎい すん 〈くっ付き
たっぴらかすん	たっぴらかすん 〈ぺしゃんこになる〉【活】
たながーいん	たながーいん 〈変種が生まれる〉【活】たな
たっくぃー	たっくぃー 〈血統〉 【例】あまー でぃき
たながーい むん	たながーい むん 〈変わり種〉 【例】う
たとぅい	たとぅい 〈事例〉 【例】なままでぃ うん
たなげー	たなげー 〈エビ〉 【例】やんばるぬ かーら
たび すがい	たび すがい 〈旅支度、旅の装い〉 【例】
たぬしみ	たぬしみ 〈楽しみ〉 【例】うむいるぐとぅ
たに	たに 〈男の性器〉 【例】たねー じんくぇー
たばいん	たばいん 〈縛る〉【活】たばたん、たばらん、
たび にんじゅ	たび にんじゅ 〈旅の集団〉 【例】ちかぐ
たびぬ っちゅ	たびぬ っちゅ 〈よそ者〉 【例】ぐまし
たばい	たばい〈〜束（野菜、サトウキビ、等）〉 【例】
だび	だび 〈葬式〉 【例】たんかーぬ だべー あ
たぶいん	たぶいん 〈蓄える〉【活】たぶたん、たぶらん、
たばく	たばく 〈煙草〉 【例】なままでー たばこー
たび	たび 〈旅〉 【例】たびんかい いちゅんどー
たぼーいん	たぼーいん 〈くださる〉【活】たぼーたん、た
たまうどぅん	たまうどぅん 〈霊御殿〉 【例】たまうどぅ
たま	たま 〈玉、宝玉〉 【例】ありが とぅじぇー
たまがい	たまがい 〈人の死の前兆、火玉〉 【例】たま
たまし	たまし 〈注意、思慮〉 【例】っちゅんかい 
たまいん	たまいん 〈溜まる〉 【例】じのー ちかい
たまい みじ	たまい みじ 〈溜まり水〉 【例】たまいみ
たまし くぇー かーぎ／ちら だま	たまし くぇー かーぎ／ちら だま
し	し 〈賢そうな顔つき〉 【例】あぬ わらべー
たまし くぇー むん	たまし くぇー むん 〈思慮深い者〉
だまいん	だまいん 〈黙る〉【活】だまたん、だまらん、
たまし ぬぎーん	たまし ぬぎーん 〈びっくりする〉【活】〜
たみし	たみし 〈試し〉 【例】じんとー ゆーりーぬ
たみし すん	たみし すん 〈試す〉【活】〜さん、〜さん、〜
たまし	たまし 〈めいめいの分け前〉 【例】うれー 
たむちゅん	たむちゅん 〈⻑持ちする〉【活】たむちゃん、
たみ	たみ 〈ため〉 【例】うぐゎんそー いちみぬ
たみーん	たみーん 〈曲げる〉【活】たみたん、たみら
たむん	たむん 〈薪〉 【例】んかしぇー たむん め
たみーん	たみーん 〈貯める、溜める〉【活】たみたん、
たゆい	たゆい 〈便り〉 【例】いったー っくゎぬち
たりーん	たりーん 〈醸造する〉【活】たりたん、たりら
だみーん	だみーん 〈彩る、上化粧する〉【活】だみた
たりーん	たりーん 〈足す、補う〉【活】たりたん、たり
たれーいん	たれーいん 〈足す、補う〉【活】たれーたん、
たんかー まんかー	たんかー まんかー 〈差し向かい、隣り近
たんきーん	たんきーん 〈用心する〉【活】たんきたん、た
だんだん	だんだん 〈さまざま、たいそうな、たくさん〉
たんかー	たんかー 〈真向かい〉 【例】たんかー げ
〜ち	〜ち 〈〜つ、〜歳〉 【例】てぃがねー てぃー
ちー／ち	ちー／ち 〈気〉 【例】ちー ちちゅん。（気
ちー	ちー 〈血〉 【例】はなぢーぬ はとーん。（鼻
ちー かさかさー	ちー かさかさー〈気ぜわしいさま〉 【例】
ちー	ちー 〈乳、乳房〉 【例】うしぬ ちーや カル
ぢー	ぢー 〈土地〉 【例】っやーや どぅーぬ ぢ
ちー しったいん	ちー しったいん〈気力がなくなる〉【活】〜
ぢーぬ ぬーし	ぢーぬ ぬーし 〈地主〉 【例】うふぢーぬ
ぢー ぶねーい	ぢー ぶねーい 〈地揺れ〉 【例】ふにから
ちー ちちゅん	ちー ちちゅん 〈気がつく〉【活】〜ちちゃ
ぢー まーみー	ぢー まーみー 〈落花生〉 【例】ぢーまー
ちー ちちゅん	ちー ちちゅん 〈気が利く〉【活】〜ちちゃ
ちー〜	ちー〜〈すっかり〜してしまう〉
ちー けーらすん	ちー けーらすん 〈容れ物を倒してすっか
ちー ふぃらきーん	ちー ふぃらきーん 〈座り込んでしまう〉
ちー わしーん	ちー わしーん 〈すっかり忘れる〉【活】〜
ちー	ちー 〈つるべ〉 【例】ちーや かーぬ みじ 
ちーぐー	ちーぐー 〈口がきけない〉 【例】あれー 
ちーちーくーめー すん	ちーちーくーめー すん 〈窮屈な思い
ちげー	ちげー 〈関節〉 【例】ちげーぬ はんでぃー
ちーちー かーかー	ちーちー かーかー 〈喉や食道にものが
ちかいん	ちかいん 〈使う〉【活】ちかたん、ちからん、
ちかい とぅばすん	ちかい とぅばすん 〈使い果たす〉【活】〜
ちけーふぁ	ちけーふぁ 〈小遣い〉 【例】ちゅーどぅ 
ちーるー	ちーるー 〈⻩色〉 【例】ありぬ みーめーん
ちかいん	ちかいん 〈点灯する〉【活】ちかたん、ちから
ちーん、ちゆん	ちーん、ちゆん 〈釣る〉【活】ちっちゃん、
ちーん、ちゆん	ちーん、ちゆん 〈着る〉【活】ちちゃん、ち
ちがきーん	ちがきーん 〈心に留める〉【活】ちがきたん、
ちーん、ちゆん	ちーん、ちゆん 〈切る〉【活】ちっちゃん、
ちかないん	ちかないん 〈飼う〉 【例】わったーや 
ちぎーん	ちぎーん 〈告げる〉【活】ちぎたん、ちぎら
ちぐむん	ちぐむん 〈口をつぐむ〉【活】ちぐだん、ちぐ
ちぢまがいん	ちぢまがいん 〈縮みあがる〉【活】ちぢまが
ちちゃい くてーたい すん	ちちゃい くてーたい すん 〈質疑
ちしーん	ちしーん 〈便秘する〉【活】ちしたん、ちしら
ちじーん	ちじーん 〈妨げる、禁止する〉【活】ちじたん、
ちちゃがいん	ちちゃがいん 〈つけあがる〉【活】ちやがた
ぢしち	ぢしち 〈儀式〉 【例】にーびちねー さかじ
ちち	ちち 〈月〉 【例】がっこーや くんちちから
ちちゃぎーん	ちちゃぎーん 〈支える〉【活】ちちゃぎた
ちちゅん	ちちゅん 〈聞く〉【活】ちちゃん、ちかん、ち
ちてーいん	ちてーいん 〈伝える〉【活】ちてーたん、ち
ちに いーん	ちに いーん 〈気に入る〉【活】〜いっちゃ
ちねー	ちねー 〈家庭〉 【例】なーちねーぢねーぬ 
ちちゅん	ちちゅん 〈効く、収まる〉【活】ちちゃん、ち
ちとぅ	ちとぅ 〈引き出物、近辺からの手みやげ〉
ちちゅん	ちちゅん 〈付く、着く〉【活】ちちゃん、ちか
ちぬく	ちぬく 〈きのこ〉 【例】なかみじる、いなむ
ぢのーん	ぢのーん 〈宜野湾〉 【例】ふてぃま ひこ
ちび	ちび 〈尻〉 【例】ちび くくい（締めくくり、
ちび たっちゅー	ちび たっちゅー 〈お尻のとがっている
ちび とぅがやー／とぅがるー	ちび とぅがやー／とぅがるー 〈お
ちぶる	ちぶる 〈頭〉 【例】ちぶる っんぶー（頭が
ちまいん	ちまいん 〈詰まる、縮まる〉 【例】やしむ
ちみ	ちみ 〈爪〉 【例】にぢりぬ うふいーびんか
ちみーん	ちみーん 〈詰める、短くする〉【活】ちみた
ちむ	ちむ 〈こころ〉 【例】いっとぅちぇー ふかん
ちむ だくだくー すん	ちむ だくだくー すん 〈胸をときめか
ちむ どんどん すん	ちむ どんどん すん 〈ドキドキする〉
ちむ ぐち	ちむ ぐち 〈みぞおち〉 【例】なーだ む
ちむ ぐくる	ちむ ぐくる 〈心〉 【例】ゆすぐにをぅて
ちむ むち	ちむ むち 〈心がけ〉 【例】っちょー ち
ちむえー	ちむえー 〈意味、わけ〉 【例】ちむえーん
ちゃー	ちゃー 〈茶〉 【例】ちゃーぬ しんぬ たっ
ちゃーいん	ちゃーいん 〈消える〉【活】ちゃーたん、ち
ちゃんなぎーん	ちゃんなぎーん 〈捨ててしまう〉【活】ち
〜ちゅ	〜ちゅ 〈1〉 【例】ちゅくとぅば（一言）、ち
ちゃーすん	ちゃーすん 〈消す〉【活】ちゃーちゃん、ち
ちゅ い	ちゅ い 〈一人〉 【例】ちゅいんぐゎ（一人
ちゅ まーい／ちゅまーる	ちゅ まーい／ちゅまーる 〈ひとまわり〉
ちゅ みー	ちゅ みー 〈一睡〉 【例】ちゃーが ない
ちゅ うぇー ぐとぅ	ちゅ うぇー ぐとぅ 〈一大事〉 【例】
ちゅ かき	ちゅ かき 〈一切れ〉 【例】あわてぃー 
ちゅー	ちゅー 〈今日〉 【例】ちぬー（昨日）、をぅ
ちゅ ちち ぐし	ちゅ ちち ぐし 〈一月おき〉 【例】くぬ
ちゅーいん	ちゅーいん 〈成育する〉【活】ちゅーたん、ち
ちゅ ちねー	ちゅ ちねー 〈一世帯〉 【例】っちゅち
ちゅ とぅし	ちゅ とぅし 〈同じ年〉 【例】ありとぅ 
ちゅーごー すん	ちゅーごー すん 〈しめし合わす〉【活】〜
ちゅ ふぃさ	ちゅ ふぃさ 〈一足〉 【例】ちゅふぃさ 
ちゅ ばち	ちゅ ばち 〈一発、一撃〉 【例】うとぅう
ちゅくいん	ちゅくいん 〈つくる〉【活】ちゅくたん、ち
ちゅくい むぢゅくい	ちゅくい むぢゅくい 〈農作物〉 【例】
ちら	ちら 〈顔〉 【例】ちら むっち あっからん。
ちら ふっくゎー	ちら ふっくゎー〈ふくれっ面の者〉 【例】
ちゅくりーん	ちゅくりーん 〈繕う〉【活】ちゅくりたん、
ちゅーみーん	ちゅーみーん 〈強める〉【活】ちゅーみた
ちりーん	ちりーん 〈（極限状態に達して）切れる〉【活】
ちるがいん	ちるがいん 〈浸かる〉【活】ちるがたん、ち
〜ぢゅらさ	〜ぢゅらさ 〈かしこくも〜、尊くも〜〉 【例】
ちる だい	ちる だい 〈だるいさま、元気をなくしてい
ちるむん	ちるむん 〈交接する〉【活】ちるだん、ちるま
ちんちきーん	ちんちきーん 〈つねる〉【活】ちんちきた
ちろー	ちろー 〈器量〉 【例】ちろー じんぶん う
ちわみーん	ちわみーん 〈決める〉【活】ちわみたん、ち
ちんぺー	ちんぺー 〈唾〉 【例】ちんぺー とぅーみ
ちんぼーらー	ちんぼーらー 〈小さな巻貝の一種〉 【例】
ちんまがいん	ちんまがいん 〈ひん曲がる〉【活】ちんま
ちわまいん	ちわまいん 〈決まる〉【活】ちわまたん、ち
ちん／ちんちるかー	ちん／ちんちるかー 〈服、衣類〉 【例】
ぢんみ すん	ぢんみ すん 〈協議する〉【活】〜さん、〜さ
っちゅ	っちゅ 〈人〉 【例】あぬ っちょー がくむ
っちゅ うやめー	っちゅ うやめー 〈人を敬うこと〉 【例】
っちゅ あし	っちゅ あし 〈人の往来〉 【例】みーさ 
っちゅ かじ	っちゅ かじ 〈会う人ごとに〉 【例】あぬ
っちゅ あとぅ	っちゅ あとぅ 〈人に後れること〉 【例】
っちゅ かしまさー	っちゅ かしまさー〈人間嫌い〉 【例】わ
っちゅ うじ	っちゅ うじ 〈人見知り〉 【例】わらべー
っちゅ がわいー むん	っちゅ がわいー むん 〈変わり者〉
っちゅ うしぇー むにー	っちゅ うしぇー むにー 〈人をあなど
っちゅ ぐとぅ	っちゅ ぐとぅ 〈人との交際〉 【例】どぅ
っちゅ だき	っちゅ だき 〈人の丈〉 【例】やしみに 
っちゅ ふるばさー	っちゅ ふるばさー 〈借金を踏み倒す者〉
っちゅ だまさー	っちゅ だまさー 〈人をだます者、詐欺師〉
っちゅ びれー	っちゅ びれー 〈人付き合い〉 【例】むぬ
っちゅ まさい	っちゅ まさい 〈人に勝ること〉 【例】た
っちゅ にんぢん	っちゅ にんぢん 〈人間〉 【例】ちぬー、
っちゅ まま	っちゅ まま 〈人の言いなり〉 【例】わら
っちゅぬ かーたー	っちゅぬ かーたー 〈最低な人間〉 【例】
っちゅ めー	っちゅ めー 〈人前〉 【例】っちゅめー 
っちゅ はだ	っちゅ はだ 〈人肌〉 【例】さけー っち
っちゅ うぃー	っちゅ うぃー 〈人酔い〉 【例】っちゅぬ
っちゅ ばっぺー	っちゅ ばっぺー 〈人違い〉 【例】どぅ
てぃー	てぃー 〈手〉 【例】あまむん しかんぬーん
てぃー がんまり すん	てぃー がんまり すん 〈手を触れる〉
てぃー あんだ	てぃー あんだ〈料理に込めた愛情〉 【例】
てぃー うさーすん	てぃー うさーすん 〈合掌する、手をあわ
てぃー さーじ	てぃー さーじ 〈手ぬぐい〉 【例】しぇー
てぃー さぐい	てぃー さぐい 〈手探り〉 【例】あった
てぃー じくん	てぃー じくん 〈握りこぶし〉 【例】んか
てぃー じょーきー	てぃー じょーきー 〈取手付きのかご〉
てぃーおー さおー すん	てぃーおー さおー すん 〈右往左
てぃー ぢかーん すん	てぃー ぢかーん すん 〈手づかみする〉
てぃー ねーい ふぃさ ねーい す	てぃー ねーい ふぃさ ねーい す
ん	ん 〈けんかを挑む〉【活】〜さん、〜さん、〜っし
てぃー ちかいん	てぃー ちかいん 〈空手をつかう〉【活】〜
てぃー はごーさ すん	てぃー はごーさ すん 〈嫌がる〉【活】〜
てぃー ぢゅくい	てぃー ぢゅくい 〈手作り〉 【例】てぃー
てぃー とぅら とぅらー すん	てぃー とぅら とぅらー すん 〈一緒
てぃー ふぃさ まちぶい	てぃー ふぃさ まちぶい 〈足手まとい〉
てぃー とー だーちー すん	てぃー とー だーちー すん 〈拱手傍
てぃー まーまー すん	てぃー まーまー すん 〈うろたえる〉
てぃー まーみ	てぃー まーみ 〈手豆〉 【例】てつぼー 
てぃーぬ くび／なー／はた／わた	てぃーぬ くび／なー／はた／わた〈手
てぃー まっくゎ	てぃー まっくゎ 〈自分の手で枕すること〉
てぃー もー	てぃー もー 〈手がない者〉 【例】いくさ
てぃーよー ふぃさよー すん	てぃーよー ふぃさよー すん 〈手振り
てぃー わじゃ	てぃー わじゃ 〈手仕事〉 【例】んかしぬ
てぃー わたし すん	てぃー わたし すん〈手渡しする〉【活】〜
でぃーぐ	でぃーぐ 〈でぃご〉 【例】でぃーごー あ
てぃーだ	てぃーだ 〈太陽〉 【例】なちぬ てぃーだ
てぃーだ あみ	てぃーだ あみ 〈にわか雨〉 【例】くぬ
てぃーだ ぶい	てぃーだ ぶい 〈日照雨〉 【例】てぃーだ
てぃーだ ぶーい	てぃーだ ぶーい 〈ひなたぼっこ〉 【例】
てぃーち	てぃーち 〈1 つ〉
てぃーち みしー	てぃーち みしー 〈年子〉 【例】あれー 
てぃー わちゃれー ないん	てぃー わちゃれー ないん 〈手をわず
てぃーち むん	てぃーち むん 〈同じもの〉 【例】てぃ
てぃー っんぢゃーり	てぃー っんぢゃーり 〈やっかいなことに
てぃしみ がくむん	てぃしみ がくむん 〈学問〉 【例】て
てぃーる	てぃーる 〈手かご〉 【例】ふぃーらーとぅか、
てぃびち	てぃびち 〈手疋、豚足の煮込み料理〉 【例】
てぃーん	てぃーん 〈照る〉【活】てぃたん、てぃらん、
てぃふん	てぃふん 〈手本〉 【例】しんしーぬ てぃ
でぃかすん	でぃかすん 〈よくやる〉【活】でぃかちゃん、
てぃま とぅやー	てぃま とぅやー 〈日雇い労働者〉 【例】
でぃきーん	でぃきーん 〈できる〉【活】でぃきたん、で
てぃみじ	てぃみじ 〈手ですくった水〉 【例】やんば
てぃがねー	てぃがねー 〈手伝い〉 【例】わらび そー
てぃがら	てぃがら 〈功労〉 【例】っくゎぬ むんな
てぃら	てぃら 〈寺、拝所〉 【例】すいんかえー くゎ
てぃぐまー	てぃぐまー 〈手先が器用な者〉 【例】あれ
てぃん	てぃん 〈天〉
てぃんちゃま	てぃんちゃま 〈いたずら〉 【例】わらべ
てぃんしー	てぃんしー 〈天水〉 【例】てぃんしー かー
てぃん がーら	てぃん がーら 〈天の川〉 【例】うちな
てぃんぬ っちゅ	てぃんぬ っちゅ 〈天上人〉 【例】ぢのー
てぃん みー	てぃん みー 〈天命〉 【例】てぃんみー 
てぃんじょー	てぃんじょー 〈天井〉 【例】どぅーぬ や
てぃんぷら	てぃんぷら 〈てんぷら〉 【例】うちなーを
てぃんさーぐー	てぃんさーぐー 〈ホウセンカ〉 【例】て
とぅい	とぅい 〈鶏〉 【例】いゆ こーらー まぎさ
とぅいん	とぅいん 〈取る、もらう〉【活】とぅたん、と
とぅい けーすん	とぅい けーすん 〈取り戻す〉【活】〜けー
とぅい しがいん	とぅい しがいん 〈とりすがる〉【活】〜し
とぅい どぅくる	とぅい どぅくる 〈⻑所〉 【例】ぬーぬ 
とぅい のーすん	とぅい のーすん〈取り直す、改める〉【活】〜
とぅい ぶさ かってぃー すん	とぅい ぶさ かってぃー すん 〈取
とぅい しまいん	とぅい しまいん 〈取り締まる〉【活】〜し
とぅい ちめーいん	とぅい ちめーいん 〈かき集める〉【活】〜
どぅー ふぃじゅやー／どぅー ふぃじゅるー	どぅー ふぃじゅやー／どぅー ふぃじゅるー 〈冷え性の者〉 【例】うぃなぐぬ
とぅいん ちかみん ならん	とぅいん ちかみん ならん 〈制御でき
とぅーぬ いーび	とぅーぬ いーび 〈10 本の指〉 【例】とぅーぬ いーべー ゐんたけー ねーらんぐと
どぅー ぶに	どぅー ぶに 〈体の骨〉 【例】うぬ とぅ
どぅー ぶに のーし	どぅー ぶに のーし〈骨休め〉 【例】さ
どぅー	どぅー 〈体〉 【例】どぅーぬ どぅーや ど
どぅー っんぶさ	どぅー っんぶさ 〈体が重いこと〉 【例】
どぅー	どぅー 〈自分〉 【例】どぅく をぅたてぃ 
あち どぅー	あち どぅー 〈体の熱っぽい者〉 【例】あ
どぅー ぢゅくい	どぅー ぢゅくい 〈体格〉 【例】ありが 
どぅー あがち	どぅー あがち 〈自活、自立〉 【例】わー
どぅー にー	どぅー にー 〈うなること〉 【例】っやー
どぅー あがみ／どぅー うやめー	どぅー あがみ／どぅー うやめー〈う
どぅー あたい／うちあたい	どぅー あたい／うちあたい 〈自分の心
どぅー ゆい	どぅー ゆい 〈自己責任、自業自得〉 【例】
どぅー くる	どぅー くる 〈自分自身で〉 【例】どぅー
どぅー ちゅい あっち	どぅー ちゅい あっち 〈一人歩き、独
どぅー わちゃれー	どぅー わちゃれー 〈手に負えない状態〉
どぅー ちゅい むにー	どぅー ちゅい むにー 〈独り言〉 【例】
とぅーいん	とぅーいん 〈問う〉【活】とぅーたん、とぅ
どぅー なー	どぅー なー〈自分たち（話者を除く一人称
とぅーいん	とぅーいん 〈通る〉【活】とぅーたん、とぅ
どぅー むち	どぅー むち 〈身持ち〉【活】どぅー むち
とぅーい みち	とぅーい みち 〈通り道〉 【例】がっこー
とぅがらすん	とぅがらすん 〈とがらす〉【活】とぅがらち
とぅーすん	とぅーすん 〈通す〉【活】とぅーちゃん、と
とぅがみーん	とぅがみーん 〈とがめる〉【活】とぅがみた
とぅきーん	とぅきーん 〈溶ける〉【活】とぅきたん、と
とぅーぬちゅん	とぅーぬちゅん 〈遠のく〉【活】とぅーぬ
どぅきないん	どぅきないん 〈避ける、退く〉【活】どぅき
とぅーみー かがん	とぅーみー かがん 〈望遠鏡〉 【例】と
とぅーみかすん	とぅーみかすん 〈唾をペっと吐く〉【活】
どぅきなすん	どぅきなすん 〈退ける〉【活】どぅきなちゃ
とぅぬー まーぬー	とぅぬー まーぬー 〈道に迷うさま〉
とぅがいん	とぅがいん 〈とがる〉【活】とぅがたん、と
とぅく	とぅく 〈徳、得〉 【例】とぅく とぅてぃ 
とぅじゃ ないん	とぅじゃ ないん 〈銛のように鋭くなる〉
どぅく	どぅく 〈毒〉 【例】やなぐち さい、みっく
とぅく むち	とぅく むち 〈徳のある者〉 【例】くぬ
とぅし	とぅし 〈年、歳〉 【例】くとぅし（今年）、く
とぅしぬ くー	とぅしぬ くー 〈年の功〉 【例】「かーみ
とぅくる	とぅくる 〈場所〉 【例】っうぃーりき どぅ
とぅしぬ とぅじ みーとぅ	とぅしぬ とぅじ みーとぅ 〈⻑年連れ
どぅげーいん	どぅげーいん 〈転ぶ〉【活】どぅげーたん、
とぅしぬ ゆーる	とぅしぬ ゆーる 〈大晦日〉 【例】とぅし
とぅし びー	とぅし びー 〈生年祝い〉 【例】13、25、
とぅじゃ	とぅじゃ 〈銛〉 【例】みーかがん はち し
とぅち とぅい	とぅち とぅい 〈時刻選び〉 【例】とぅ
とぅし わらび	とぅし わらび 〈年齢相応な知恵がない者〉
とぅじ	とぅじ 〈妻〉 【例】っやー をぅとー した
とぅじ っくゎ	とぅじ っくゎ 〈妻子〉 【例】うやぬ 
とぅぢゅん	とぅぢゅん 〈研ぐ〉【活】とぅぢゃん、とぅ
どぅちゅん	どぅちゅん 〈退く、別れる〉【活】どぅちゃ
とぅっ〜／とぅん〜	とぅっ〜／とぅん〜〈強意を表す〉 【例】
とぅじきーん	とぅじきーん 〈命令する〉【活】とぅじきた
とぅっ かかいん	とぅっ かかいん 〈つっかかる〉【活】〜か
とぅじまいん	とぅじまいん 〈仕上がる〉【活】とぅじま
とぅっ かちみーん	とぅっ かちみーん 〈捕まえる〉【活】〜か
とぅじみーん	とぅじみーん 〈仕上げる〉【活】とぅじみた
とぅっ くゎいん	とぅっ くゎいん 〈噛みつく〉【活】〜た
とぅっ くゎい むにー すん	とぅっ くゎい むにー すん 〈噛みつ
とぅっちみーん	とぅっちみーん 〈とっちめる〉 【例】ゆく
とぅっちり ぢん	とぅっちり ぢん 〈絣の着物〉 【例】とぅ
とぅでーいん	とぅでーいん 〈途絶える〉【活】とぅでーた
とぅどぅくーいん	とぅどぅくーいん 〈滞る、消化不良を起
とぅどぅちゅん	とぅどぅちゅん 〈届く〉【活】とぅどぅち
とぅん もーいん	とぅん もーいん 〈びっくりする〉【活】〜
とぅっちーん	とぅっちーん 〈詰まらせる、むせる〉【活】
とぅない	とぅない 〈隣り〉 【例】わったー とぅない
とぅなか	とぅなか 〈沖合い〉 【例】ふに ぬてぃ 
どぅっとぅ	どぅっとぅ 〈とても〉 【例】あぬ うふや
とぅぬぢゅん	とぅぬぢゅん 〈跳ねる〉【活】とぅぬだん、
とぅぶいん	とぅぶいん 〈灯る〉【活】とぅぶたん、とぅ
どぅまんぐゎすん	どぅまんぐゎすん 〈うろたえさせる〉【活】
とぅぶすん	とぅぶすん 〈灯す〉【活】とぅぶちゃん、と
とぅぶん	とぅぶん 〈飛ぶ〉【活】とぅだん、とぅばん、
とぅばすん	とぅばすん 〈飛ばす〉【活】とぅばちゃん、と
とぅみーん	とぅみーん 〈止める〉【活】とぅみたん、と
とぅぶー	とぅぶー 〈とび魚〉 【例】ふなたび そー
とぅみーん	とぅみーん 〈書き留める〉【活】とぅみたん、
とぅまいん	とぅまいん 〈泊まる〉【活】とぅまたん、と
とぅむ ぐー	とぅむ ぐー 〈足の付け根、股関節〉 【例】
どぅまんぐぃーん	どぅまんぐぃーん 〈うろたえる〉【活】ど
とぅめーいん	とぅめーいん 〈探し求める、尋ねる〉【活】
とぅらぬ じゅー	とぅらぬ じゅー 〈千歳蘭〉 【例】うち
〜とぅらすん	〜とぅらすん 〈〜してやる〉【活】〜とぅら
とぅやーかやー すん	とぅやーかやー すん 〈バランスがと
とぅりーん	とぅりーん 〈凪ぐ〉【活】とぅりたん、とぅ
とぅやーすん	とぅやーすん 〈揃えて整える、まとめる〉
どぅる	どぅる 〈泥〉
とぅゆむん	とぅゆむん 〈世間に鳴り響く〉【活】とぅゆ
どぅる ぐぇったい	どぅる ぐぇったい〈泥んこ〉 【例】んか
どぅる びさ	どぅる びさ 〈泥んこ足〉 【例】あみふい
とぅゆまりーん	とぅゆまりーん 〈評判である〉【活】とぅ
どぅる ぶったー／どぅるびっちゃー	どぅる ぶったー／どぅるびっちゃー
とぅ んぢーん	とぅ んぢーん 〈飛び出す〉【活】〜んぢた
どぅる わかしー／どぅーるわかしー	どぅる わかしー／どぅーるわかしー
とぅるばいん	とぅるばいん 〈ぼんやりする〉【活】とぅ
とぅるとぅる すん	とぅるとぅる すん 〈うたた寝する〉
とぅん〜	とぅん〜〈急に動く〉
とぅん たちー ゐー すん	とぅん たちー ゐー すん〈しゃがむ〉
とぅ んぢゅん／とぅぬぢゅん	とぅ んぢゅん／とぅぬぢゅん 〈跳びだ
とぅん とぅるもーかー すん	とぅん とぅるもーかー すん 〈跳びあ
とぅん まーいん	とぅ ん  ま ー い ん 〈ち ょ っ と 立 ち 寄 る〉
とぅん くぃーゆん	とぅん くぃーゆん 〈跳び越える〉【活】〜
とぅん もーい もーい すん	とぅん もーい もーい すん 〈躍り上
とぅ んけーいん	とぅ んけーいん 〈振り向く〉【活】〜んけ
とぅんじー	とぅんじー 〈冬至〉 【例】とぅんじーねー、
とぅんだー ぶん	とぅんだー ぶん 〈東海盆〉 【例】とぅ
とぅんじゃく	とぅんじゃく 〈介護、看病、扱い〉 【例】
てー	てー 〈耐える力、はね返す力〉 【例】すーじ
てー	てー 〈〜と言い〉 【例】いちゅんてー、いか
てー	てー 〈松明〉
てー ちちゅん	てー ちちゅん 〈燃えつく〉【活】〜ちちゃ
でー	でー 〈代金、値段〉 【例】うれー でーや 
てー はてぃーん	てー はてぃーん 〈絶滅する〉【活】〜はて
でー だかー	でー だかー 〈値段の高いもの〉【活】でー
てー びー	てー びー 〈たいまつ〉 【例】ギリシャか
てーくく	てーくく 〈大国〉 【例】くにぬ まぎさ っ
てーてー むぬ いー／てーてー むにー	てーてー むぬ いー／てーてー むにー 〈舌がもつれるようなものの言
でーくに	でーくに 〈大根〉 【例】でーくにぬ っん
てーげー	てーげー 〈おおよそ、まずまずの〉 【例】わ
てーげー ざんみん	てーげー ざんみん〈概算〉 【例】てーげ
てーふぁ	てーふぁ 〈冗談〉 【例】っちゅぬ なーか
〜てーまん	〜てーまん 〈〜ても〉 【例】ちゃっさ い
でーじ	でーじ 〈大変、大ごと〉 【例】でーじな く
てーしち	てーしち 〈大切〉 【例】ぬー やてぃん て
てんぶす	てんぶす 〈出べそ〉 【例】なーふぁぬ まん
てーすん	てーすん 〈費やす〉【活】てーちゃん、てーさ
とー	とー 〈中国〉
とー あちれー	とー あちれー 〈中国製品〉 【例】んかし
とーびーらー／ふぃーらー	とーびーらー／ふぃーらー 〈ゴキブ
とーぬ くに	とーぬ くに 〈中国〉 【例】なまやてぃん
とーかち	とーかち 〈米寿のお祝い〉 【例】とーかち
とーふ	とーふ 〈豆腐〉 【例】うちなー とーほー 
とーしんばい	とーしんばい 〈耳下腺炎〉 【例】うふっ
とーふ まーみ	とーふ まーみ 〈大豆〉 【例】とーふまー
とーすん	とーすん 〈倒す〉【活】とーちゃん、とーさ
とーとーめー	とーとーめー 〈祖先の位牌〉 【例】とー
どーま すん	どーま すん 〈もうろく〉【活】〜さん、〜さ
とーりら とーりら	とーりら とーりら 〈今にも倒れそうな
とんとんみー	とんとんみー 〈飛びハゼ〉 【例】っやー
なー	なー 〈菜〉 【例】からしなや うちなーをぅ
なー	なー 〈縄〉 【例】ちなふぃちぬ なーんかえ
なー	なー 〈名前〉 【例】っやー なーや ぬー 
なー	なー 〈庭、広場〉 【例】わったー むらんか
なー	なー 〈それぞれ〉 【例】なー ちねーぢねー
なー	なー 〈いざと、終わり〉 【例】いちゅさんで
なー	なー 〈翌、再〉 【例】なー あさてぃ（しあ
なー やーん	なー やーん 〈再来年〉 【例】にーびち
なー ゐーる っちゅ	なー ゐーる っちゅ 〈有名な人〉
なーか	なーか 〈中〉 【例】くぬ なーかー ぬーぬ
なーでぃー	なーでぃー 〈経由して〉 【例】まー な
なーび	なーび 〈鍋〉 【例】んかしぇー ムーチーん
なびげー	なびげー 〈おたま〉 なーびぬ けー（鍋の
なーべーらー	なーべーらー 〈へちま〉 【例】なーべー
ないん	ないん 〈なる〉【活】なたん、ならん、なてぃ
なーか	なーか 〈仲〉 【例】なげー むぬん いらん、
なーく	なーく 〈脈〉 【例】あったばい さくとぅ 
ない がたー	ない がたー 〈〜になりかけ〉 【例】わっ
なーちゃ	なーちゃ 〈翌日〉 【例】あちゃーぬ なー
ない はんすん	ない はんすん 〈なり損なう〉【活】〜はん
ない くじりーん	ない くじりーん 〈出来損なう〉【活】〜く
ないん	ないん 〈鳴る〉【活】なたん、ならん、なてぃ
ない ちーん	ない ちーん 〈なりきる〉【活】〜ちっちゃ
なか	なか 〈中、仲〉
ないん	ないん 〈できる〉【活】なたん、ならん、なて
ならん ぬー	ならん ぬー 〈けしからん者〉 【例】いち
なか じん	なか じん 〈中心、中央〉 【例】やしちぬ
なか だち	なか だち 〈仲人、仲介〉 【例】たーんか
なか てぃー	なか てぃー 〈中ぐらい〉 【例】なかてぃ
なか めー	なか めー 〈茶の間、居間〉 【例】なかめ
ないん	ないん 〈生る、実ができる〉 【例】マンゴー
なが〜	なが〜〈⻑〉
なが たび	なが たび 〈⻑旅〉 【例】ながたべー い
ない （むん）	ない （むん）〈果物〉 【例】くとぅしぇー
なが ちび	なが ちび 〈⻑居〉 【例】っちゅぬ やー
なぎ んちゅん	なぎ んちゅん 〈投げ込む〉 【例】ゆぐ
なが わちゃれー	なが わちゃれー 〈⻑患い〉 【例】ながわ
なげーさ	なげーさ 〈⻑いこと〉 【例】なげーさ いち
ながすん	ながすん 〈流す〉【活】ながちゃん、ながさ
ながし あみ	ながし あみ 〈通り雨、にわか雨〉 【例】
ながみーん	ながみーん 〈免ずる〉【活】ながみたん、な
なげー なやー	なげー なやー 〈年代物〉 【例】うれー
なぐさみーん	なぐさみーん 〈慰める〉【活】なぐさみた
なぐさむん	なぐさむん 〈慰む〉【活】なぐさだん、なぐ
なかみ じる	なかみ じる 〈中味汁〉 【例】なかみじ
ながりーん	ながりーん 〈流れる〉【活】ながりたん、な
なけーすん	なけーすん 〈泣かす〉【活】なけーちゃん、な
なぎーん	なぎーん 〈投げる〉【活】なぎたん、なぎら
なさがすん	なさがすん 〈陰口をする〉【活】なさがちゃ
なしーん	なしーん 〈塗る〉【活】なしたん、なしらん、
なし むぬ っくゎ	なし むぬ っくゎ 〈子宝〉 【例】にん
なじきーん	なじきーん 〈そぶりをする〉【活】なじきた
なし はんじょー すん	なし はんじょー すん〈出産する〉【活】〜
なし ふぃるぎーん	なし ふぃるぎーん〈子孫を増やす〉【活】〜
なすん	なすん 〈産す〉【活】なちゃん、なさん、なち
なし みー	なし みー〈里方〉 【例】うぃなごー にー
なし	なし 〈産み〉
なし あがいん	なし あがいん 〈鶏が卵を産まなくなる〉
なし うや	なし うや〈産みの親〉 【例】なしうや や
なし ぐゎ	なし ぐゎ〈産んだ子〉 【例】わんねー な
なだ	なだ 〈涙〉 【例】あながちさる はなし ち
なだ ぐるまーい	なだ ぐるまーい 〈涙ぐんださま、今にも
なち	なち 〈夏〉
なち ぐち	なち ぐち 〈初夏〉 【例】なちぐち ない
なし ぢち	なし ぢち 〈臨月〉 【例】なしぢち やく
なち むん	なち むん 〈夏もの〉 【例】かりゆしウェ
なちゅん	なちゅん 〈鳴く〉【活】なちゃん、なかん、な
なち ぶさー	なち ぶさー 〈泣き虫〉 【例】めーなち 
なち むにー	なち むにー 〈泣きながらものを言うこと〉
なち われー	なち われー 〈泣き笑い〉 【例】っちゅぬ
なちょーら	なちょーら 〈海人草〉 【例】わらび そー
なでぃ すだてぃーん	なでぃ すだてぃーん 〈かわいがって
なちゅん	なちゅん 〈泣く〉【活】なちゃん、なかん、な
ななち ふし	ななち ふし 〈北斗七星〉 【例】にしぬ
なち かかいん	なち かかいん 〈泣きつく〉【活】〜かかた
なぬいん	なぬいん 〈名乗る〉【活】なぬたん、なぬら
なち ねーび	なち ねーび 〈泣きまね〉 【例】わらびと
なばくいん	なばくいん 〈からかう、ひやかす〉【活】なば
なまたり むん	なまたり むん 〈怠け者〉 【例】しくちん
なまちな むん	なまちな むん 〈気の荒い者〉 【参】「な
なま	なま 〈現時点〉 【例】うちなーゆーから や
なま あし ばい	なま あし ばい 〈冷や汗をかくこと〉
なまりーん	なまりーん 〈なまる〉【活】なまりたん、な
なまらー、なまてー、しくちゃー	なまらー、なまてー、しくちゃー 〈おど
なま わらび	なま わらび 〈未熟な子〉 【例】くとぅぬ
なま じらー	なま じらー 〈生意気者〉 【例】っちゅ
なま じさー、なま しさー、なま じし	なま じさー、なま しさー、なま じし 〈生肉〉 【例】ししぇー なまじ
なみむさー	なみむさー 〈なめくじ〉 【例】あみぬ ふ
ならーすん	ならーすん 〈教える、しつける〉【活】なら
なまたりーん	なまたりーん 〈怠ける〉【活】なまたりた
ならーし よー	ならーし よー 〈しつけ〉 【例】わらび 
ならび	ならび 〈隣り〉 【例】がっこーぬ ならびん
ならいん	ならいん 〈習う〉【活】ならたん、ならーん、
なりーん	なりーん 〈慣れる〉【活】なりたん、なりら
なれー	なれー〈習い〉 【例】「やー なれーぬ ふか
〜なれー	〜なれー 〈〜の習い事〉 【例】がっこー 
ならすん	ならすん 〈平らにする、粉にする〉【活】なら
なりーん	なりーん 〈親密になる、なじむ〉【活】なりた
なんか	なんか 〈7 日ごとの法事〉 【例】なんかんでぃ いーしぇー っちゅぬ まーしーねー、な
なんくる みー すん	な ん く る   み ー   す ん 〈自 生 す る〉
ならすん	ならすん 〈鳴らす〉【活】ならちゃん、ならさ
なんぢ	なんぢ 〈難儀〉 【例】なんぢさーや よーが
なんぢ くんぢ	なんぢ くんぢ 〈苦労〉 【例】わんねー
ならぶん	ならぶん 〈並ぶ〉【活】ならだん、ならばん、
なんちち	なんちち 〈焦げ付き〉 【例】んかしぇー は
なんどぅち	なんどぅち 〈何時／何日〉 【例】なまー／
なんどぅる むん	なんどぅる むん 〈滑りやすいもの〉
なんでーしー	なんでーしー 〈桑の実〉 【例】なんでーし
にーにー うーさー	にー 〈荷〉 【参】にーちらすん、にーむちゅん。にー うーさー 〈荷物を運ぶもの〉 【例】
にー	にー 〈根〉
にーからぬ	にーからぬ 〈根っからの〉 【例】あれー 
にー うーしーん	にー うーしーん 〈荷物を負わす、負担を
にー	にー 〈値〉 【例】うふかじぬ あとぅぬ ぶ
にー ふだ	にー ふだ 〈価格表示〉 【例】くりんかえ
にー がん	にー がん〈集落の神官〉【活】にー やー／
にー ぐい	にー ぐい 〈根っこ〉 【例】やふぁたー 
にー すーら	にー すーら 〈根と梢〉 【例】やなむんば
にー ばい	にー ばい 〈根張り〉【活】にー ぢり〈根
にー	にー 〈音色〉 【例】さんしんぬ にー あぎ
にー びち	にー びち〈結婚式〉 【例】なままでー さ
にーしぇ	にーしぇ 〈⻘年〉 【例】ぶんぬ みっちゃ
にー ぢちゅん	にー ぢちゅん 〈根づく〉【活】〜ぢちゃ
にーぬふぁぬ みふし、にーぬふぁぶし	にーぬふぁぬ みふし、にーぬふぁぶし 〈北極星〉 【例】ゆる はらす 
にー ちらすん	にー ちらすん 〈根絶させる〉【活】〜ちら
にー ちりーん	にー ちりーん 〈根治する〉【活】〜ちりた
にーび	にーび 〈赤土の一種〉 【例】んかしぇー じ
にーびる／のーびる	にーびる／のーびる 〈のびる、ねびる〉
にー むちゅん	にー むちゅん 〈根にもつ〉【活】〜むっち
にーぶ	にーぶ 〈ひしゃく〉 【例】「にーぶ」んでぃ
にーいん	にーいん 〈煮える〉【活】にーたん、にーら
にーぶ がー	にーぶ がー 〈ひしゃくで直接汲める井戸〉
にーいん	にーいん 〈練る〉【活】にーたん、にーらん、
にーぶい	にーぶい 〈居眠り〉 【例】にっかまでぃ 
にーゆん	にーゆん 〈煮える〉【活】にーたん、にーら
にー くたー	にー くたー 〈煮過ぎてくたくたになって
にーぶい ぐさ	にーぶい ぐさ 〈オジギソウ〉 【例】にー
にー しぢーん	にー しぢーん 〈煮すぎる〉
にーぶい みー	にーぶい みー 〈眠たそうな目〉 【例】っ
にーぶい かーぶい すん	にーぶい かーぶい すん 〈こっくりこ
にーゆん	にーゆん 〈練る〉【活】にーたん、にーらん、
にがいん	にがいん 〈願う〉【活】にがたん、にがらん、
にーぶやー	にーぶやー 〈寝坊〉 【例】あれー にーぶ
にが ゆー	にが ゆー 〈凶年〉 【例】あみぬ ふいぢ
にーぶたー	にーぶたー 〈腫れ物〉 【例】んかしぇー 
にぐーにぐー すん	にぐーにぐー すん 〈ゆったりしてい
にぐとぅ	にぐとぅ 〈寝ごと〉 【例】うむくとぅどぅ
にーん／にゆん	にーん／にゆん 〈似る〉【活】にちゃん、に
にーん／にゆん	にーん／にゆん 〈煮る〉【活】にちゃん、に
にげー	にげー 〈祈り〉 【例】にげーどぅ しぇーう
にたかまんた	にたかまんた 〈似た者同士〉 【例】どぅ
にしーん	にしーん 〈似せる〉【活】にしたん、にしら
にち	にち 〈熱、温度〉 【例】にちぬ あみ？ に
にじーん	にじーん 〈がまんする〉【活】にじたん、にじ
にじ でー	にじ でー 〈忍耐力〉 【例】にじでーぬ 
にじー かんてぃー すん	にじー かんてぃー すん 〈がまんでき
にし ぶち	にし ぶち 〈北風〉 【例】うちなーをぅて
にぢーん	にぢーん 〈握る〉【活】にぢたん、にぢらん、
にぢり めー	にぢり めー 〈握り飯〉 【例】がっこー
にぢむん	にぢむん 〈つねる〉【活】にぢだん、にぢま
にじゃまさ すん	にじゃまさ すん 〈寝ぼける〉【活】〜さ
にぶ っんまり	にぶ っんまり 〈遅生まれ〉 【例】ふぇ
にじゃみ うどぅるち すん	にじゃみ うどぅるち すん 〈夢で
にりん	にり ん 〈飽きる〉【活】にりたん、にりらん、
にりがさがさ すん	にりがさがさ すん 〈食べ物に砂などが
にん	にん 〈年〉 【例】ちゅとぅ（１年）、たとぅ（２
にん とぅー	にん とぅー 〈年始〉 【例】あきまどぅし
にんぐる	にんぐる 〈愛人、情夫〉 【例】あれー と
にんじーん	にんじーん 〈念じる〉【活】にんじたん、に
にん	にん 〈念〉 【例】っやー しーよーや に
にん がきーん	にん がきーん 〈心がける、志す〉【活】〜が
にん ぐゎん	にん ぐゎん 〈念願〉 【例】アミリカーた
にんじ ぐとぅ	にんじ ぐとぅ 〈願いごと〉 【例】っやー
にんしーん	にんしーん 〈寝かす、放ったらかす〉【活】に
にん ぶとぅきー	にん ぶとぅきー 〈すべりひゆ〉 【例】に
にんぢ くげー	にんぢ くげー 〈寝返り〉 【例】っやーや
にん りち	にん りち〈念力〉 【例】めーなち にげー
にんぢ じゃま	にんぢ じゃま 〈寝相〉 【例】わらべー 
にんじゅ	にんじゅ 〈人数、一団〉 【例】ちかぐろー
にんじゅ あらたみ	にんじゅ あらたみ〈人数調査、人数確認〉
にんぢ ちげー	にんぢ ちげー 〈寝違い〉 【例】にんぢち
にんぢ ぢら	にんぢ ぢら 〈寝顔〉 【例】わらびぬ に
にんぢゃー っうぃーぢ	にんぢゃー っうぃーぢ 〈背泳〉 【例】
にんぢゅん	にんぢゅん 〈寝る〉【活】にんたん、にんだ
にんぢ はぎ	にんぢ はぎ 〈床ずれ〉 【例】ながわちゃ
にんぢ はな	にんぢ はな 〈寝入りばな〉 【例】にんぢ
にんぢ ふりーん	にんぢ ふりーん 〈爆睡する〉 【例】ゆな
にんぢ ぐくち	にんぢ ぐくち 〈寝心地〉 【例】「きしゃ
にんぢ やんぢゅん	にんぢ やんぢゅん 〈寝損なう〉【活】〜や
にんぢん	にんぢん 〈人間〉 【例】にんぢのー ちむ
ぬいん	ぬいん 〈塗る〉【活】ぬたん、ぬらん、ぬてぃ
ぬい	ぬい 〈糊〉 【例】ぬぬさーに ぬくやーめー
ぬー がな	ぬー がな 〈何か〉 【例】っやーや わん
ぬー ぐとぅ	ぬー ぐとぅ 〈何事〉 【例】ぬーぐとぅぬ
ぬい むん	ぬい むん〈塗りもの、漆器〉 【例】うちな
ぬいん	ぬいん 〈乗る〉【活】ぬたん、ぬらん、ぬてぃ
ぬーとぅ くぃーとー	ぬーとぅ くぃーとー〈詳細〉 【例】ぬー
ぬー ぬー	ぬー ぬー 〈何と何〉 【例】ぬーぬー こ
ぬーぬ さびん ねーらん	ぬーぬ さびん ねーらん 〈何の差し障
ぬーやー くぃーやー	ぬーやー くぃーやー 〈何やかや〉 【例】
ぬー	ぬー 〈何〉 【例】っちゅが ぬー さわん 
ぬーん くぃーん	ぬーん くぃーん 〈何もかも〉 【例】っち
ぬーる	ぬーる 〈神人〉 【例】ヌールんでぃ いーし
ぬーし	ぬーし 〈本人〉 【例】ぬーしんちょーん わ
ぬーじ	ぬーじ 〈虹〉 【例】わらび そーいに かぐ
ぬーでぃー	ぬーでぃー 〈喉〉
ぬーでぃー ぐーふー	ぬーでぃー ぐーふー 〈喉仏〉 【例】ぬ
ぬーでぃー ぢる	ぬーでぃー ぢる 〈声帯〉 【例】ぬーでぃ
ぬがーりーん	ぬがーりーん 〈逃れる〉 【参】「ぬぢゅん」
ぬがーらすん	(2019a;123,180–181 頁)。ぬがーらすん〈勘弁する、見逃す〉【活】ぬが
ぬかぐ	ぬかぐ 〈米や糠に発生する虫〉 【例】ぬーが
ぬぎーん	ぬぎーん 〈抜ける〉【活】ぬぎたん、ぬぎら
ぬぎーん	ぬぎーん 〈逃げる〉【活】ぬぎたん、ぬぎら
ぬーでぃー っわーぐゎー	ぬーでぃー っわーぐゎー 〈喉ちんこ〉
ぬぎ じこーい	ぬぎ じこーい 〈逃げ支度〉 【例】かとー
ぬーり	ぬーり 〈苔〉 【例】くむいんかい ほーとー
ぬく〜	ぬく〜〈暖か〉 【例】ぬくさん（暖かい）から
ぬく ぐに	ぬく ぐに 〈暖かい地方〉 【例】うちなー
ぬく どぅし	ぬく どぅし 〈暖冬の年〉 【例】ぬくぐに
ぬくいん	ぬくいん 〈残る〉【活】ぬくたん、ぬくらん、
ぬくい むん	ぬくい むん 〈残りもの〉 【例】なちぇー
ぬくたまいん	ぬくたまいん 〈暖まる〉【活】ぬくたまた
ぬくたみーん	ぬくたみーん 〈暖める〉【活】ぬくたみた
ぬくばーいん	ぬくばーいん 〈暖かくなる〉【活】ぬくばー
ぬぐいん	ぬぐいん 〈拭きとる〉【活】ぬぐたん、ぬぐら
ぬしーん	ぬしーん 〈載せる〉【活】ぬしたん、ぬしらん、
ぬしかいん	ぬしかいん 〈ちょっと顔を出す〉【活】ぬし
ぬくすん	ぬくすん 〈残す〉【活】ぬくちゃん、ぬくさん、
ぬしきーん	ぬしきーん 〈差し出す〉【活】ぬしきたん、
ぬぢふぁ	ぬぢふぁ 〈霊魂はずし〉 【例】ふるばかを
ぬち かぢり	ぬち かぢり 〈一生懸命〉 【例】っちゅに
ぬち がふー	ぬち がふー 〈命拾い〉 【例】まぎじこ 
ぬち かんぱー	ぬち かんぱー〈生き返ったような心地、命
ぬじゅむん	ぬじゅむん 〈望む〉【活】ぬじゅだん、ぬじ
ぬじゅみ	ぬじゅみ 〈望み〉 【例】っやー ぬじゅめ
ぬち ぐすい	ぬち ぐすい 〈非常においしいもの〉 【例】
ぬすどぅ	ぬすどぅ 〈どろぼう〉 【例】ぬすどぅんかい
ぬすむん	ぬすむん 〈盗む〉【活】ぬすだん、ぬすまん、
ぬち してぃ むん	ぬち してぃ むん 〈命をそまつにする
ぬち してぃ わじゃ	ぬち してぃ わじゃ 〈命がけの仕事〉
ぬち	ぬち 〈命〉 【例】うふぃぐゎー やてぃん 
ぬち ぢる	ぬち ぢる 〈命の弦〉 【例】しわぐとぅぬ
ぬち だしき	ぬち だしき 〈救命〉 【例】うみをぅてぃ
ぬち ちり ばたらち	ぬち ちり ばたらち 〈死にもの狂いで働
ぬちとぅ かくがー	ぬちとぅ かくがー〈命がけ〉 【例】いく
ぬち どぅくる	ぬち どぅくる 〈急所〉 【例】てぃー ち
ぬちぬ うや	ぬちぬ うや 〈命の恩人〉 【例】うぬ っ
ぬちぬ ぐすーじ	ぬちぬ ぐすーじ〈命拾いのお祝い〉 【例】
ぬちぬ しんたく	ぬちぬ しんたく 〈命の洗濯〉 【例】っち
ぬちゅん	ぬちゅん 〈貫く〉【活】ぬちゃん、ぬかん、ぬ
ぬち くるすん	ぬち くるすん〈刺し殺す〉【活】〜くるちゃ
ぬち ふぃち すん	ぬち ふぃち すん〈非難する〉 【例】ふ
ぬち むん	ぬち むん 〈刺繍〉 【例】はーいさーに 
ぬちゅん	ぬちゅん 〈募る〉【活】ぬちゃん、ぬかん、ぬ
ぬちゃーすん	ぬちゃーすん 〈持ち寄る〉【活】ぬちゃーち
ぬばすん	ぬばすん 〈延ばす、伸ばす〉【活】ぬばちゃん、
ぬち しん	ぬち しん 〈募金〉 【例】とーほくぬ う
ぬぢゅん	ぬぢゅん 〈抜きとる、追い抜く、撮る〉【活】
ぬばちりーん	ぬばちりーん 〈くたばる〉【活】〜ちりた
ぬぢゅん	ぬぢゅん 〈だます〉【活】ぬぢゃん、ぬがん、
ぬば ちり むん	ぬば ちり むん 〈だらしない者〉 【例】
ぬびーん／ぬぶん	ぬびーん／ぬぶん 〈伸びる、延びる、が
ぬぬ	ぬぬ 〈布〉 【例】んかしぬ っちょー どぅー
ぬばがいん	ぬばがいん 〈ちょっと顔を見せる〉【活】ぬ
ぬばがい かーぎ	ぬばがい かーぎ 〈ちっとも顔を見せない
ぬび	我慢しておくさ (といって足蹴りする)）。ぬび 〈寛容さ〉【活】ぬび でー〈抱擁力〉
ぬーび	ぬーび 〈（手足を伸ばして）くつろぐこと〉
ぬぶん	ぬぶん 〈伸びる〉【活】ぬだん、ぬばん、ぬで
ぬむん	ぬむん 〈飲む、受け入れる〉【活】ぬだん、ぬ
ぬびぬび	ぬびぬび 〈延び延びに〉 【例】どぅく い
ぬぶいん	ぬぶいん 〈登る、（中心地、中央に）向かう〉
ぬみ どぅし	ぬみ どぅし 〈飲み友だち〉 【例】とぅし
ぬみ みじ	ぬみ みじ 〈飲み水〉 【例】ぬみみじぇー
ぬぶいくだい すん	ぬぶいくだい すん 〈坂を上り下りす
ぬらいん	ぬらいん 〈叱る〉【活】ぬらたん、ぬららん、
ぬぶしーん	ぬぶしーん 〈のぼせる、夢中になる〉【活】ぬ
ぬるっくぃーん	ぬるっくぃーん 〈なまぬるくなる〉【活】
ぬるむん	ぬるむん 〈ぬるむ〉【活】ぬるだん、ぬるま
ぬるみーん	ぬるみーん 〈ぬるめる〉【活】ぬるみたん、ぬ
ねー	ねー 〈地震〉 【例】ねーぬ ゆとーたしが、あ
ねー	ねー 〈苗〉 【例】ゴーヤーん ナーベーラー
ねーいん	ねーいん 〈なえる〉【活】ねーたん、ねーら
ねーいん 	ねーいん  〈（話し手に）物をわたす、（相手
ねーぐー	ねーぐー 〈びっこ〉 【例】ねーぐーんねーっ
ねーとぅ けーとぅ	ねーとぅ けーとぅ 〈似合い、似たり寄
ねーび	ねーび 〈まね〉 【例】っちゅぬ ねーびっ
ねーん、ねーらん	ねーん、ねーらん 〈無い〉【活】ねーんた
〜ねーん	〜ねーん 〈〜してしまった〉 【例】メール
のーいん	のーいん 〈綱をなう〉【活】のーたん、のーら
のーすん	のーすん 〈直す〉【活】のーちゃん、のーさ
のーらすん	のーらすん 〈仕立て直す〉【活】のーらちゃ
のーいん	のーいん 〈直る〉【活】のーたん、のーらん、
のーたる	のーたる 〈当然の、ふさわしい〉 【例】っ
のーが	のーが 〈名誉〉 【例】うやふぁーふじぬ い
はーっ	はーっ 〈へえ〉 【例】はーっ、でーじ なと
はー	はー 〈⻭〉 【例】はーぬ むし くゎとーん。
はー かき むにー	はー かき むにー〈舌足らず〉 【例】は
はー もー	はー もー 〈⻭がないこと〉 【例】はーも
ばー	ばー 〈の、もの、ところ、時、わけ〉 【例】
はーい	はーい 〈針〉 【例】わったーや はーいぬ 
はーえー	はーえー 〈駆け足〉 【例】あったに あみ 
はーがー、ひゃーがー	はーがー、ひゃーがー 〈（車の）タイヤ〉
ばーき	ばーき 〈ざる、かご〉 【例】あら ばーき
ぱーらんくー	ぱーらんくー 〈太鼓の一種〉 【例】パー
はーりー／はーれー	はーりー／はーれー 〈爬龍船漕ぎ〉
はーち	はーち 〈鉢〉 【例】はなばーちんかい みじ
ばーばー	ばーばー 〈勢いよく燃えているさま〉 【例】
はいん	はいん 〈流れる、走る〉【活】はたん、はらん、
はーべーるー	はーべーるー 〈蝶〉 【例】はーべーるー
はらすん	はらすん 〈流す、走らせる〉【活】はらちゃ
はーや	はーや 〈柱〉 【例】んかしぇー みーぢん 
はいん	はいん 〈張る〉【活】はたん、はらん、はてぃ
はいん	はいん 〈貼る〉【活】はたん、はらん、はてぃ
はいん	はいん 〈下半身を露出する〉【活】はたん、は
まる ばい	まる ばい 〈下半身のまる出し〉
はかすん	はかすん 〈弁償させる〉【活】はかちゃん、は
はぎーん	はぎーん 〈剥ける〉【活】はぎたん、はぎら
はく	はく 〈箱〉 【例】ちゅはく、たはく、みはく、
ばさー	ばさー 〈芭蕉、芭蕉布〉 【例】くれー ばさ
はか	はか 〈墓〉 【例】かーみなくーばか／かーみぬ
ばさー ぢん	ばさー ぢん 〈芭蕉布の着物〉 【例】ばさ
はかいん	はかいん 〈計る〉【活】はかたん、はからん、
はかやー むし	はかやー むし 〈しゃくとり虫〉 【例】は
はかぐち	はかぐち 〈仕事のし始め〉 【例】くぬ わじ
ばさ ない	ばさ ない 〈バナナ〉 【例】ばさなえー 
はし	はし 〈橋、はしご〉 【例】やーぬ っうぃーん
はじ	はじ 〈恥〉 【例】はじ ちらー（恥知らず）。
はじ	はじ 〈はず、推測〉 【例】っやーん いちゅ
ばす／ばー	ばす／ばー 〈とき、際、わけ〉 【例】うぬ
はじち	はじち 〈入れ墨〉 【例】んかしぇー、うちな
はしる	はしる 〈開戸〉 【例】はしるぐち／とぅばし
はた	はた 〈端、そば〉 【例】うみばた（海端）、み
はしし	はしし 〈⻭茎〉 【例】ちゅくいばーぬ あた
はじまいん	はじまいん 〈始まる〉【活】はじみたん、は
はじみーん	はじみーん 〈始める〉【活】はじみたん、まじ
はたかいん	はたかいん 〈場所を取る〉【活】はたかたん、
はじゃきーん	はじゃきーん 〈〜しそこなう〉【活】はじ
はたらちゅん	はたらちゅん 〈働く〉 【例】はたらちゅ
はだ むち	はだ むち 〈肌心地〉 【例】うちなーや 
はちか そーぐゎち	はちか そーぐゎち 〈沖縄の正月の最終
ばち	ばち 〈罰〉 【例】やなぐとぅ しーねー、ばち
ばち くゎいん	ばち くゎいん 〈幸運である〉【活】〜くゎ
ぱちみかすん	ぱちみかすん 〈パチンと音をたてる〉【活】
ばち	ばち 〈（太鼓やどらを）打つ棒〉 【例】てーく
はち〜	はち〜〈初〉 【例】はちあっちー（初歩き）、
はちゃー	はちゃー 〈蜂〉 【例】はちゃーんかい さ
はちゅん／はきーん	はちゅん／はきーん 〈掛ける〉【活】はち
はぢーん／はぢゅん	はぢーん／はぢゅん 〈脱ぐ〉【活】はぢ
はちゅん	はちゅん 〈吐く〉【活】はちゃん、はかん、は
はちゃい ふぃっちゃい	はちゃい ふぃっちゃい 〈吐いたり下し
はちゅん	はちゅん 〈発つ、逝く〉【活】はちゃん、はた
はぢゅん	はぢゅん 〈配る〉【活】はぢゃん、はがん、は
はぢゅん	はぢゅん 〈船を造る〉【活】はぢゃん、はが
ぱったり げーやー すん	ぱったり げーやー すん 〈パタパ
はちゅん	はちゅん 〈弁償する〉【活】はちゃん、はか
はかすん	はかすん 〈弁償させる〉【活】はかちゃん、は
はっちりーん	はっちりーん 〈はじける〉【活】はっちり
はちゃ ぐみ	はちゃ ぐみ 〈もち米のおこし〉 【例】は
はっちりら ちりら すん	はっちりら ちりら すん 〈はちきれそ
はぢゅん	はぢゅん 〈剥ぐ〉【活】はぢゃん、はがん、は
はっちゃかいん	はっちゃかいん 〈出くわす〉【活】はっち
はっとぅ	はっとぅ 〈禁止〉 【例】っちゅぬ あちまい
はっぷがすん	はっぷがすん 〈吐き出す〉【活】はっぷがち
はてぃ	はてぃ 〈終わり、キリ〉 【例】あわりぬ 
はっぱいん	はっぱいん 〈大きく見開く〉【活】はっぱた
ばっぺー	ばっぺー 〈間違い〉 【例】みちばっぺー（道
はな	はな 〈鼻〉 【例】はな ふちゅん。（いびきをか
はながさ	はながさ 〈花笠〉 【例】はながさー をぅ
はな ふぃちゅん	はな ふぃちゅん〈くしゃみをする〉 【例】
はなすん	はなすん 〈離す〉【活】はなちゃん、はなさ
はなすん	はなすん 〈話す〉【活】はなちゃん、あなさ
はなし はんがく	はなし はんがく 〈話半学〉 【例】っちゅ
はな しち	はな しち 〈風邪（鼻が湿気ていること）〉
はな	はな 〈はじめ〉 【例】にーはな やくとぅ、ふ
はねーかすん	はねーかすん 〈盛り上げる〉【活】はねーか
はねーちゅん	はねーちゅん 〈盛り上がる〉【活】はねーち
はばかいん	はばかいん 〈広い場所をとる〉【活】はばか
はな	はな 〈花〉
はな あたい	はな あたい 〈花園〉 【例】やーぬ めー
はな いちー	はな いちー 〈花瓶〉 【例】はないちー 
ばばっくゎーすん	ばばっくゎーすん 〈ごまかす〉【活】ばば
はら	はら 〈方面、側〉 【例】あぬ はら（あっち
はら	はら 〈⺟方の親戚〉 【例】はら わかやー（⺟
はばちゅん	はばちゅん 〈はかどる、さばく、たいらげる〉
はらいん	はらいん 〈払う〉【活】はらたん、はらーん、
はぶ	はぶ 〈毒蛇〉 【例】ハブぬぐとぅ かくじぬ 
はらい めー	はらい めー 〈支払い〉 【例】はらいめー
はらすん	はらすん 〈流す、走らせる〉【活】はらちゃ
はまいん	はまいん 〈頑張る〉【活】はまたん、はまら
はらすん	はらすん 〈晴らす〉【活】はらちゃん、はらさ
はりーん	はりーん 〈晴れる〉【活】はりたん、はりら
はりーん	はりーん 〈腫れる〉【活】はりたん、はりら
ばんじ	ばんじ 〈さなか〉 【例】むぬ かどーる ば
ばりん	ばりん 〈たわし〉 【例】ふかから けーて
はんじょー すん	はんじょー すん 〈栄える〉【活】〜さ
はる	はる 〈耕地〉 【例】はる あっちゃー（農業従
はんすん	はんすん 〈はずす〉【活】はんちゃん、はんさ
はんち げーいん	はんち げーいん 〈はね返る〉【活】〜げー
はる	はる 〈墓〉 【例】はる まぶやー（墓で「ま
〜はんすん	〜はんすん 〈〜機会をうしなう〉【活】〜はん
はろーじ、っうぇーか はろーじ	はろーじ、っうぇーか はろーじ
はんぶぬー	はんぶぬー 〈半分、半丁〉 【例】とーほー
ばんみかすん	ばんみかすん 〈バタンと音をたてる、思い
はんた	はんた 〈端〉 【例】はんたゐー しーねー 
はんだま	はんだま 〈はるたま、水前寺菜〉 【例】は
はんちゅん	はんちゅん 〈はじく、まく〉【活】はんちゃ
はんめー	はんめー 〈ご飯〉 【例】っやー はんめー
はんでぃーん	はんでぃーん 〈ほどける〉【活】はんでぃた
びーちゃー	びーちゃー 〈もぐらの一種〉 【例】びーちゃ
びけー／びけーじ／びけーん／びかー	びけー／びけーじ／びけーん／びかー 〈だけ（限定）〉 【例】とぅーびけー
びじゅる／びんじゅる	びじゅる／びんじゅる 〈⻯宮の神が祭
ひゃーがいん	ひゃーがいん 〈干し上がる〉【活】ひゃーが
ひやみかすん	ひやみかすん 〈気合いを入れる〉【活】ひや
ひょーし	ひょーし 〈偶然、機会〉 【例】あま っんぢ
びちー	びちー 〈べき〉 【例】っやーや いーびちー
びら	びら 〈ネギ〉 【例】びらー ちぶるぬ をぅ
ひっくゎーすん	ひっくゎーすん 〈ひく〉【活】ひっくゎー
びんしー	びんしー 〈酒や水を入れる道具、瓶子〉 【例】
びんがた	びんがた 〈紅型〉 【例】びんがた ぢん 
ふいーてぃ	ふいーてぃ 〈不得意〉 【例】っちゅぬ 
ふいん	ふいん 〈降る〉【活】ふたん、ふらん、ふてぃ
ふいん	ふいん 〈掘る〉【活】ふたん、ふらん、ふてぃ
ふい っんぢゃすん	ふい っんぢゃすん 〈掘り出す〉【活】〜っ
ふい けーすん	ふい けーすん 〈（病気が）再び悪化する〉
ふー	ふー 〈幸運〉 【例】ぬーが やら あさから
ふー	ふー 〈穂〉 【例】っんにぬ ふーぬぐとぅ 
ふいん	ふいん 〈振る〉【活】ふたん、ふらん、ふてぃ
ふー、なれー	ふー、なれー 〈風習〉 【例】やーぬ／むら
ふー	ふー 〈帆〉 【例】ふーだかぶにぬ とーりや
ふー	ふー 〈はい〉 【例】しーじゃー しーじゃ 
ふーかさー	ふーかさー 〈ほら吹き〉 【例】あれー ふ
ふー	ふー 〈頬〉
ふー くぶー	ふー くぶー 〈頬くぼみ〉 【例】っやーや
ふー けーいん	ふー けーいん 〈ふくらむ〉【活】ふーけー
ふー けーらすん	ふー けーらすん 〈ふくらます〉【活】ふー
ふーち	ふーち 〈モグサ〉 【例】わらび そーいに 
ふーぢ	ふーぢ 〈流儀、風采〉 【例】くまー くまぬ
ふーぢー	ふーぢー 〈なりふり〉 【例】しんしー／い
ふーち ばー	ふーち ばー 〈ヨモギ〉 【例】んかしぇ
ふー ぢら	ふー ぢら 〈頬〉 【例】ゆちぐにぬ わら
ふー たい	ふー たい〈頬たれ〉【活】ふー たやー〈頬
ふーなー	ふーなー 〈ふり〉 【例】でぃきやー／しっ
ふーち	ふーち 〈流行病〉 【例】なま ふーちぬ ふ
ふかすん	ふかすん 〈沸かす〉【活】 ふかちゃん、ふか
ふかすん	ふかすん 〈（芋を）煮る、（まんじゅうを）蒸
ふーび	ふーび 〈褒美〉 【例】まるふぃーじーぬ う
ふがすん	ふがすん 〈穴をあける〉【活】ふがちゃん、ふ
ふーりんなー	ふーりんなー 〈ほうれん草〉 【例】ふー
ふか	ふか 〈外、他〉 【例】やー なれーどぅ ふか
ふぎーん	ふぎーん 〈穴があく〉【活】ふぎたん、ふぎら
ふかから ちやー	ふかから ちやー 〈外着〉 反意語は、やー
ぶかりー	ぶかりー 〈縁起が悪いこと〉 【例】あさん
ふく	ふく 〈肺〉 【例】ふくまーみ（心臓）、たき
ふぎ	ふぎ 〈欠損〉 【例】くんちちぇー ふげー 
ふきーん	ふきーん 〈さえずる〉【活】ふきたん、ふきら
ふぐい	ふぐい 〈ふぐり〉 【例】いん まやー ちか
ふくい	ふくい 〈ほこり〉 【例】ふくいぬ みーんか
ふきーん	ふきーん 〈くぐる〉【活】ふきたん、ふきら
ふくいん	ふくいん 〈喜ぶ〉【活】ふくたん、ふくらん、
ふきーん	ふきーん 〈老ける〉【活】ふきたん、ふきら
ぶくー	ぶくー 〈不器用〉 【例】ぶくーな むん（不
ふくぎー	ふくぎー 〈産毛〉 【例】なまぬ うぃきが
ふぐ すん	ふぐ すん 〈処分する〉【活】〜さん、〜さ
ふくっとぅ すん	ふ く っ と ぅ   す ん 〈不服な様をする〉
ふくたー	ふくたー 〈ボロ〉 【例】ちんぬ みーや 
ふくたー むし	ふくたー むし 〈みの虫〉 【例】くーばー
ふくぢ	ふくぢ 〈フクギ〉 【例】やーぬ まーいん
ふくふく すん	ふくふく すん 〈いい香りがする〉【活】〜
ふく まーみ	ふく まーみ 〈心臓〉 【例】ししぬ ふ
ふさ すん	ふさ すん 〈欲する〉【活】〜さん、〜さん、〜
ふくちち	ふくちち 〈悪臭を放つゴミ〉 【例】まやーぬ
ふさぢゅん	ふさぢゅん 〈ふさぐ〉【活】ふさぢゃん、ふ
ふし むん	ふし むん 〈干し物〉 【例】なまー ちん
ふす	ふす 〈へそ〉 【例】てんぶす（出べそ、突起
ふし	ふし 〈星、運気〉 【例】ななち ぶしぇー 
ふすく	ふすく 〈不足〉 【例】うぐゎん ぶすく（祈
ふし	ふし 〈節〉 【例】わん みーや ふしぬ み
ふだ いり	ふだ いり 〈投票〉 【参】いりーん。
ふちき	ふちき 〈繊維くず、髪のくず〉 【例】っやー
ふしぢゅん	ふしぢゅん 〈防ぐ〉【活】ふしぢゃん、ふし
ふすん	ふすん 〈干す〉【活】ふちゃん、ふさん、ふし
ぶちくん／ぶちげー	ぶちくん／ぶちげー 〈気を失いそうな状
ふちばんた	ふちばんた 〈断崖〉 【例】ふちばんたんか
ふちまー	ふちまー 〈さかき（榊）〉 【例】ふちまーや
ふちゅん	ふちゅん 〈沸く〉【活】ふちゃん、ふかん、ふ
ふちゃーいん	ふちゃーいん 〈生い茂る〉【活】ふちゃーた
ふちゃぎ	ふちゃぎ 〈あずきを表面にくっつけた餅〉
ふちゅん	ふちゅん 〈吹く〉【活】ふちゃん、ふかん、ふ
ふぢゅん	ふぢゅん 〈満足する〉【活】ふぢゃん、ふが
ぶちゅーい	ぶちゅーい 〈発育不良〉 【例】ぶちゅーい
ふちゅくる	ふちゅくる 〈懐〉 【例】うやぬ ふちゅく
ぶちりー	ぶちりー 〈不潔（人に対して用いる）〉 【例】
ふっくぃーん	ふっくぃーん 〈ふくれる〉【活】ふっくぃ
ふとぅふとぅー すん	ふとぅふとぅー すん 〈心配で震える〉
ぶったらー／ぶったらこー	ぶったらー／ぶったらこー 〈太いも
ふどぅ	ふどぅ 〈身体、身⻑〉 【例】ふどぅぬ まぎ
ぶってー	ぶってー 〈でぶ〉 【参】同義語として、く
ぶっとぅー	ぶっとぅー 〈でぶ、太いもの〉 【例】まー
ふとぅちゅん	ふとぅちゅん 〈ほどく〉【活】ふとぅちゃ
ふどぅーい	ふどぅーい 〈反対〉 【例】なまから あと
ふみかすん	ふみかすん 〈盛り上げる〉【活】ふみかちゃ
ふどぅふどぅ	ふどぅふどぅ 〈年頃〉 【例】いったー う
ふに	ふに 〈骨、茎〉 【例】ぐるくのー あんだんか
ふみちゅん	ふみちゅん 〈蒸し暑い〉【活】ふみちゃん、ふ
ふみち	ふみち 〈熱気〉 【例】うちなーぬ まふっく
ふみーん	ふみーん 〈ほめる〉【活】ふみたん、ふみら
ふゆー	ふゆー 〈怠け者〉 【例】ふゆー（怠け者）、ぬ
ふみ たっくゎすん	ふみ たっくゎすん 〈大げさにほめる〉
ふらきーん	ふらきーん 〈開ける〉【活】ふらきたん、ふ
ふりーん	ふりーん 〈惚れる〉【活】ふりたん、ふりらん、
ふらちゅん	ふらちゅん 〈開く、吹かす〉【活】ふらちゃ
ぶり〜	ぶり〜〈群〉
ぶり ぶし	ぶり ぶし 〈群星〉 【例】「てぃんぬ ぶ
ぶらげー	ぶらげー 〈ほら貝、うどの大木〉 【例】ふど
ふるばすん	ふるばすん 〈金銭を踏倒す〉【活】ふるばち
ふり〜	ふり〜〈限度が過ぎた、バカな〉 【例】ふりゆ
ふり ぢから	ふり ぢから 〈馬鹿力〉 【例】っちゅぬ 
ふり むん	ふり むん 〈バカ〉 【例】っやーや ふり
ふるみーん	ふるみーん 〈古くする〉【活】ふるみたん、ふ
ふるむん	ふるむん 〈古くなる〉【活】ふるだん、ふるま
ふんしー	ふんしー 〈風水〉 【例】うちなーや なち
ぶんぢらー／ぶんぢり	ぶんぢらー／ぶんぢり 〈棒切れ〉 【例】
〜ふん	〜ふん 〈（数詞として、鉛筆などの）〜本〉
ふんでー すん	ふんでー すん 〈わがままをする〉【活】〜
ぶん	ぶん 〈品格〉 【例】あぬ っちょー ぶんぬ
べー／べーる	べー／べーる 〈嫌だ（否定）〉 【例】しか
ぼー／ぶい／ぶち	ぼー／ぶい／ぶち 〈棒／短い棒／細い棒〉
ほーりいん	ほーりいん 〈こぼれる〉【活】ほーりたん、ほ
ほー いん	ほー いん 〈こぼす〉【活】ほーたん、ほー
ほーいん	ほーいん 〈這う〉【活】ほーたん、ほーらん、
ほー らすん	ほー らすん 〈這わせる〉【活】ほーらちゃ
ほー い がじまる	ほー い がじまる 〈根が這いすぎたガジ
ぼーじゃー	ぼーじゃー 〈坊主、乳児〉 【例】あんだく
ほーちゃく	ほーちゃく 〈爆竹〉 【例】ババンバンバ
ほーち んちゅん	ほーち んちゅん 〈かき込む〉【活】〜んち
ほーちゅん	ほーちゅん 〈清掃する、ビンタをする〉【活】
ぼーちり／ぼーちらー	ぼーちり／ぼーちらー 〈乱暴者〉 【例】
ほーとぅ	ほーとぅ 〈鳩〉 【例】ほーとぅや くーが 
ふぁー	ふぁー 〈葉〉 【例】はなしぇー はな さか
ふぁーふぁー	ふぁーふぁー 〈火照っていること〉 【例】
ふぁんない すん	ふ ぁ ん な い   す ん 〈高熱が噴き出る〉
ふぃー	ふぃー 〈火〉 【例】かじん かーきとーくと
ふぃー らちゅん	ふぃー らちゅん 〈ひりひり痛む〉【活】〜
ふぃー たったー すん	ふぃー たったー すん 〈（摩擦熱、やけ
ふぃー だま	ふぃー だま 〈火玉〉 【例】ふぃーだまや
ふぃー	ふぃー 〈陽、日〉 【例】ふぃーぬ さがてぃか
ふぃー かじ	ふぃー かじ 〈日数〉 【例】わんねー す
ふぃー かたか	ふぃー かたか 〈日除け〉【活】てぃーだ 
ふぃー ちゃーさー	ふぃー ちゃーさー 〈消防士〉 【例】わ
ふぃー じー	ふぃー じー 〈常日頃〉 【例】まるふぃー
ふぃー どぅい	ふぃー どぅい 〈日取り〉 【例】やー う
ふぃー びー	ふぃー びー 〈日々、日常〉 【例】ふぃー
ふぃー むどぅい	ふぃー むどぅい 〈日帰り〉 【例】くぬ
ふぃー くし	ふぃー くし 〈欠点〉【活】やな ぐし〈悪
ふぃー	ふぃー 〈屁〉
ふぃー ふぃらー	ふぃー ふぃらー 〈おならをよくする者〉
ふぃーん	ふぃーん 〈屁を放る〉【活】ふぃっちゃん、ふ
ふぃ よー（さー）	ふぃ よー（さー）〈日雇い（労働者）〉
ふぃーうち	ふぃーうち 〈忌中〉 【例】ふぃーうちんで
ふぃ じゅー	ふぃ じゅー 〈一日中〉 【例】ちゅーや 
ふぃーさ	ふぃーさ 〈寒さ〉
ふぃーさ がたがた すん	ふぃーさ がたがた すん 〈寒さで震え
ふぃー ぐに	ふぃー ぐに 〈寒い地域〉 【例】あちぐに
ふぃーさ うみー	ふぃーさ うみー 〈寒がり〉 【例】あれー
ふぃーさ ぬー	ふぃーさ ぬー 〈悪寒〉 【例】ふぃーさぬ
ふぃーじんとー	ふぃーじんとー 〈遊びの一種〉 【例】ふ
ふぃーち	ふぃーち 〈ひいき〉 【例】っくゎ びーちゃ
ふぃーとぅ	ふぃーとぅ 〈いるか〉 【例】いくさ うわ
ふぃーさ まがい	ふぃーさ まがい 〈寒さで縮こまること〉
ふぃーじゃー	ふぃーじゃー 〈山羊〉 【例】ふぃーじゃ
ふぃーふぃー	ふぃーふぃー 〈ひゅーひゅー〉 【例】い
ふぃーじゃー がー	ふぃーじゃー がー 〈湧き水場〉 【例】
ふぃーら	ふぃーら 〈へら〉 【例】ふぃーら からちく
ふぃーらー	ふぃーらー 〈ゴキブリ〉 【例】まっくーる
ふぃさ まんち すん	ふぃさ まんち すん 〈正座する〉【活】〜
ふぃさ だかー すん	ふぃさ だかー すん 〈つま先立ちする〉
ふぃがん／ふぃんがん	ふぃがん／ふぃんがん 〈彼岸〉 【例】
ふぃさ もー	ふぃさ もー 〈足のない者〉【活】／ふぃさ
ふぃさ	ふぃさ 〈足〉 【例】うふぇー ふぃさー ぐ
ふぃさ うとぅ	ふぃさ うとぅ 〈足音〉 【例】ゆるゆなか
ふぃし	ふぃし 〈栓〉 【例】なま ぬだる さけー 
ふぃし／ふぃち すー	ふぃし／ふぃち すー 〈干潮〉 【例】
ふぃしーん	ふぃしーん 〈（厚み、濃さを）薄くする〉【活】
ふぃじゅい	ふぃじゅい 〈冷気〉 【例】ふぃじゅい い
ふぃし かーがー	ふぃし かーがー 〈透けて見える物陰〉
ふぃじゅってーん すん	ふぃじゅってーん すん 〈ひんやりする〉
ふぃし やちー	ふぃし やちー 〈薄焼き〉 【例】やまとぅ
ふぃじゅるー	ふぃじゅるー 〈冷たいもの、冷たい者〉
ふぃじ	ふぃじ 〈返事〉 【例】っちゅんかい えーじ
ふぃじゅいん	ふぃじゅいん 〈冷める〉【活】ふぃじゅた
ふぃじゅ らすん	ふぃじゅ らすん 〈冷たくする〉【活】ふ
ふぃじゅる かんぢゃー	ふぃじゅる かんぢゃー 〈寒々としてい
ふぃじゅる むん	ふぃじゅる むん 〈冷たい食べ物〉 【例】
ふぃぢゃい	ふぃぢゃい 〈左〉 【例】くぬ テレビんか
ふぃじゅる みじ	ふぃじゅる みじ 〈冷たい水〉 【例】ぬー
ふぃた	ふぃた 〈下手〉 【例】っやーや ふぃじゃい
ふぃだてぃーん	ふぃだてぃーん 〈隔てる〉【活】ふぃだて
ふぃだてぃ	ふぃだてぃ 〈隔て〉 【例】いちゃりば ち
ふぃぢゃい おーぢ めー	ふぃぢゃい おーぢ めー 〈左うちわ〉
ふぃぢゃい まちゃー	ふぃぢゃい まちゃー 〈つむじが左巻きの
ふぃぢゃい みぐい	ふぃぢゃい みぐい 〈空回り〉 【例】あ
ふぃぢ	ふぃぢ 〈髭〉 【例】っわー ふぃぢ（鼻ひげ）、
ふぃぢゃ やー／ふぃぢゃい がって	ふぃぢゃ やー／ふぃぢゃい がって
ぃ	ぃ 〈左きき〉 【例】ふぃぢゃやーや ふぃぢ
ふぃぢゃるー	ふぃぢゃるー 〈不器用、ばつが悪い〉 【例】
ふぃちないん	ふぃちないん 〈抜ける〉【活】ふぃちなた
ふぃぢゃまいん	ふぃぢゃまいん 〈隔たる〉【活】ふぃぢゃ
ふぃちなすん	ふぃちなすん 〈とって置く〉【活】ふぃちな
ふぃぢゃみーん	ふぃぢゃみーん 〈隔てる〉【活】ふぃぢゃ
ふぃちゃいん	ふぃちゃいん 〈光る〉【活】ふぃちゃたん、
ふぃぢゅん	ふぃぢゅん 〈削る〉【活】ふぃぢゃん、ふぃ
ふぃちゃい	ふぃちゃい 〈光り〉 【例】わったー なー
ふぃち	ふぃち 〈親戚〉 【例】っやーや まーぬ ふ
ふぃちゅん	ふぃちゅん 〈引く、弾く、挽く〉 【例】う
ふぃちゃい／ふぃちぇー	ふぃちゃい／ふぃちぇー 〈額〉 【例】
ふぃち あてぃーん	ふぃち あてぃーん 〈引き合わす〉【活】〜
ふぃち たちゅん	ふぃち たちゅん 〈引き立つ〉【活】〜たっ
ふぃっ かかい むっかかい すん	ふぃっ かかい むっかかい すん〈ひ
ふぃち ちーん	ふぃち ちーん 〈引きつる〉【活】〜ちた
ふぃっ かたんちゅん	ふぃっ かたんちゅん〈熱中する〉【活】ふ
ふぃち とぅいん	ふぃち とぅいん 〈引きとる〉【活】〜とぅ
ふぃち くむん	ふぃち くむん 〈（人を）引き込む〉【活】〜
ふぃち ぬぢゅん	ふぃち ぬぢゅん 〈引き抜く〉【活】〜ぬぢ
ふぃち けーすん	ふぃち けーすん 〈引き返す〉【活】〜けー
ふぃち ぬばすん	ふぃち ぬばすん 〈引き延ばす〉【活】〜ぬ
ふぃち のーすん	ふぃち のーすん 〈再確認する、改める〉
ふぃち さがいん	ふぃち さがいん 〈（空腹で）元気がなく
ふぃち しみーん	ふぃち しみーん 〈引き締める〉【活】〜し
ふぃち ゃーすん	ふぃち ゃーすん 〈引き合わす〉【活】〜ゃ
ふぃち ゃーいん	ふぃち ゃーいん 〈引き合う〉【活】〜ゃー
ふぃっ ぱい かっぱい すん	ふぃっ ぱい かっぱい すん 〈引きつ
ふぃち ゃぎーん	ふぃち ゃぎーん 〈引き揚げる〉【活】〜ゃ
ふぃちゅん	ふぃちゅん 〈干る、潮がひく〉【活】ふぃち
ふぃち むん	ふぃち むん 〈差し押さえ〉 【例】ゐーっ
ふぃち すー	ふぃち すー 〈干潮〉 【参】ふぃし。
ふぃっすいふぃっすい すん	ふぃっすいふぃっすい すん 〈ずき
ふぃっ ちーん	ふぃっ ちーん 〈引き切る〉【活】〜っちっ
ふぃっ ちり びっちり すん	ふぃっ ちり びっちり すん 〈切れ切
ふぃっちー	ふぃっちー 〈いつも、一日中〉 【例】ちゅ
ふぃっちー ぐーしー	ふぃっちー ぐーしー〈一日おき〉【活】ま
ふぃっちょー／ふぃっちぇー	ふぃっちょー／ふぃっちぇー 〈比較〉
ふぃっとぅんがすん	ふぃっとぅんがすん 〈飛び出す〉【活】ふ
ふぃっちゃてぃーん	ふぃっちゃてぃーん 〈ひっぱり上げる〉
ふぃっちぇーいん	ふぃっちぇーいん 〈ひっくり返る〉【活】
ふぃないん、ふぃーん	ふぃないん、ふぃーん 〈減る、小さくな
ふぃならすん	ふぃならすん 〈減らす、小さくする〉【活】
ふぃっちぇーらすん	ふぃっちぇーらすん 〈ひっくり返す〉
ふぃっちぇーすん	ふぃっちぇーすん 〈ぶり返す〉【活】ふ
ふぃみち すん	ふぃみち すん 〈喘息でぜいぜいする〉
ふぃにーん	ふぃにーん 〈ひねる〉【活】ふぃにたん、ふ
ふぃみち	ふぃみち 〈喘息〉 【例】ふぃみちゃー（喘
ふぃばりーん	ふぃばりーん 〈ひび割れる〉【活】ふぃばり
ふぃむん	ふぃむん 〈碑文〉 【例】ハンドーグヮーぬ 
ふぃま	ふぃま 〈暇〉 【例】いちゅなさる なーかを
ふぃら	ふぃら 〈坂〉 【例】「っうぇーき ふぃんす
ふぃま だーり	ふぃま だーり 〈暇をつぶすこと〉【活】ふ
ふぃら〜	ふぃら〜〈平たい〉
ふぃらー、ふぃら たっぺー、ふぃらべったー、ふぃらたー	ふぃらー、ふぃら たっぺー、ふぃらべったー、ふぃらたー 〈平たいもの〉 【例】
ふぃら やちー	ふぃら やちー 〈沖縄風チヂミ〉 【例】ふ
ふぃら きーん	ふぃら きーん 〈ぺたっと座る、ぺっしゃ
ふぃらいん	ふぃらいん 〈つき合う、仕える〉【活】ふぃ
ふぃれー	ふぃれー 〈つきあい〉 【例】っちゅ びれ
ふぃら かすん	ふぃら かすん 〈ぺっしゃんこにする〉【活】
ふぃら ぐん	ふぃら ぐん 〈三つ編み〉 【例】んかしぇ
ふぃらくむん	ふぃらくむん 〈しびれる〉【活】ふぃらくだ
ふぃら ふぁー ぐさ	ふぃら ふぁー ぐさ 〈オオバコ〉 【例】
ふぃらちゅん	ふぃらちゅん 〈開く〉【活】ふぃらちゃん、
ふぃるがいん	ふぃるがいん 〈広がる、繁栄する〉【活】ふ
ふぃり	ふぃり 〈へり〉 【例】たたんぬ ふぃりぬ 
ふぃりーん	ふぃりーん 〈拾う〉【活】ふぃったん、ふぃり
ふぃりー がみ	ふぃりー がみ 〈つまみ食い〉 【例】で
ふぃるぎーん	ふぃるぎーん 〈広げる、拡げる〉【活】ふぃ
ふぃり すー	ふぃり すー 〈干潮〉 【例】うちなーぐ
ふぃん	ふぃん 〈変、すねること〉 【例】ふぃんな 
ふぃん すん	ふぃん すん 〈ひねくれる〉【活】〜さん、〜
ふぃん まがいん	ふぃん まがいん 〈ひね曲がる〉【活】〜ま
ふぃる	ふぃる 〈にんにく、蒜〉 【例】んかしぇー ふ
ふぃん むでぃーん	ふぃん むでぃーん 〈ねじれる〉【活】〜む
ふぃんぐ	ふぃんぐ 〈皮膚に付いている垢、煤〉 【例】
ふぃん ぬぎーん	ふぃん ぬぎーん 〈すり抜ける〉【活】〜ぬ
ふぃんじむん	ふぃんじむん 〈ひねくれ者〉 【例】＝ふぃ
ふぃんがー まやー	ふぃんがー まやー〈汚れた猫〉 【例】ゆ
ふぃんぎーん	ふぃんぎーん 〈逃げる〉【活】ふぃんぎた
ふぃんすー	ふぃんすー 〈貧乏〉 【例】ふぃんすーむの
ふぃんがすん	ふぃんがすん 〈逃がす〉【活】ふぃんがちゃ
ふぃんち	ふぃんち 〈急に不機嫌になること〉 【例】ふ
ふぃんとー	ふぃんとー 〈返答〉 【例】ちかりーるぐと
ふぃんぷん	ふぃんぷん 〈前塀〉 【例】んかし うち
ふぃんぎ まーい	ふぃんぎ まーい 〈逃げ歩き〉 【例】むぬ
ふぇー	ふぇー 〈南〉 【例】ふぇーむてぃー（南側）、
ふぇー まーい	ふぇー まーい 〈南のなま暖かい風に変わ
ふぇー	ふぇー 〈灰〉 【例】ふぇー ちかいーねー 
ふぇー ない にし ない	ふぇー ない にし ない 〈定まってい
ふぇーぬ くすー	ふぇーぬ くすー 〈そばかす〉 【例】アミ
ふぇー	ふぇー 〈蝿〉 【例】ふぇー ぶーぶー（蝿が
ふぇー ぶちゃー	ふぇー ぶちゃー 〈夏、南風のそよぐ季節〉
ふぇーい	ふぇーい 〈流行〉
ふぇーい うた	ふぇーい うた 〈流行歌〉 【例】なまぬ 
ふぇー まーし	ふぇー まーし 〈早死に〉 【例】ゐーっち
ふぇーい くとぅば	ふぇーい くとぅば〈流行語〉 【例】なま
ふぇー みーん	ふぇー みーん 〈早める〉 【例】ゐーくと
ふぇー っんまらー	ふぇー っんまらー〈早生まれの者〉 【例】
ふぇーい やんめー	ふぇーい やんめー〈流行病〉 【例】なま
ふぇー〜	ふぇー〜〈早〉
ふぇー がってぃん	ふぇー がってぃん 〈早合点〉 【例】む
ふぇーし	ふぇーし 〈囃し〉 【例】っんまがぬちゃー
ふぇーじぇー がち	ふぇーじぇー がち 〈処方箋、配剤書
ふぇーりんちゅん	ふぇーりんちゅん 〈入り込む〉【活】ふ
ふぇー にーびち	ふぇー にーびち 〈早婚〉 【例】ふぇーに
ふぇー にんぢ	ふぇー にんぢ 〈早寝〉 【例】ちゅーや 
ふぇーれー	ふぇーれー〈追いはぎ〉 【例】たこーやまん
ぱーぱー	ぱーぱー 〈おばあさん〉 【例】すーやーぬ 
ぷちみかすん	ぷちみかすん 〈ぽきんと音をだす〉【活】ぷ
ぺーちん	ぺーちん 〈親雲上、位階名〉 【例】ぺーちん
ぱったらげーやー すん	ぱったらげーやー すん 〈抵抗する〉
ぽーぽー	ぽーぽー 〈小⻨粉と油味噌をつかった料理
ぽんみかすん	ぽんみかすん 〈ポトンと音をだす〉【活】ぽ
ぴーじゃー なすん	ぴーじゃー なすん 〈ぺっしゃんこにす
ま〜	ま〜〈真〉 【例】またんかー／まむこー（真向
まー りかー	まー りかー 〈どの辺〉 【例】くしながね
〜まー	〜まー 〈密生していること／もの〉 【例】き
まーい	まーい 〈毬、球〉 【例】くぬ ぼーじゃーや
まーいん	まーいん 〈回る、すっかり〜の状態になる〉
まー	まー 〈何処〉
まー がな	まー がな 〈何処か〉 【例】まるけーてぃ
まー むてぃー	まー むてぃー 〈どの方角〉 【例】アン
まーい	まーい 〈周り〉 【例】はなりじまとぅか、い
まーおーふぁー	まーおーふぁー 〈けしあざみ〉 【例】ま
まーじゃーくーじゃー	まーじゃーくーじゃー 〈しわくちゃ〉
まーす	まーす 〈塩〉 【例】あぐにぬ まーす ちか
まーぐー	まーぐー 〈皺の寄ったもの〉 【例】とぅし
まーす みじ	まーす みじ 〈塩水〉 【例】やなむん は
まーす にー	まーす にー 〈塩煮〉 【例】なーびんかい
まーぐー ぢら	まーぐー ぢら 〈しわくちゃ顔〉 【例】ブ
まーすん	まーすん 〈死亡する、回す〉【活】まーちゃ
まーぐー ふぃーぐー	まーぐー ふぃーぐー 〈しわくちゃ〉
まーたかだーかー	まーたかだーかー 〈肩車〉 【例】うぃき
まーじぇー	まーじぇー 〈くつわ虫〉 【例】やーぬ ま
まーち	まーち 〈松〉 【例】やんばろー まーちぬ 
まーぬ	まーぬ 〈とんでもない〉 【例】「いったーや 
まーみ なー	まーみ なー 〈もやし〉 【例】よーがりふ
まーみな くー	うな色白な男性にもやしのようだという)。まーみな くー 〈きな粉〉 【例】くじむち
まーるー	まーるー 〈順番〉 【例】くゎふーや まー
まーふぁなちゃー	まーふぁなちゃー 〈仰向けになる〉 【例】
まいん	まいん 〈大便、小便をする〉【活】またん、ま
まーみ	まーみ 〈豆〉 【例】くるまーみ（黒豆）、ぢ
まかい	まかい 〈碗〉 【例】しるまかい（お汁茶碗）、
まがいん	まがいん 〈曲がる〉【活】まがたん、まがら
まがやー ふぃぐやー すん	まがやー ふぃぐやー すん 〈曲がりく
まかすん	まかすん 〈預ける〉【活】まかちゃん、まかさ
まかねー すん	まかねー すん 〈食事を作る〉【活】〜さ
まかねー やー	まかねー やー 〈食堂〉 【例】やぐさみむ
まがるーふぃぐるー	まがるーふぃぐるー 〈ひねくれた者〉
まきーん	まきーん 〈負ける〉【活】まきたん、まきら
〜まき	〜まき 〈〜負け〉 【例】かーぬ ふぃっさる
まぎーん	まぎーん 〈曲げる〉【活】まぎたん、まぎら
まく	まく 〈わんぱく〉 【例】わらばー そーいね
まがら	まがら 〈内輪〉 【例】「まがら」んでぃ い
まぐいん	まぐいん 〈（皮膚、着物、紙などの）しわがよ
まぐい	まぐい 〈顔のしわ〉 【例】ちらぬ まぐえー
まくとぅ	まくとぅ 〈本当〉 【例】っやーや くとぅば
まさかい	まさかい 〈全盛期〉 【例】たー やてぃん 
まくとぅー	まくとぅー 〈正直者〉 【例】ふり まくと
まし	まし 〈一方よりまさること〉 【例】っやーが 
まじくい	まじくい 〈交わり〉 【例】んかしぇー と
まぐらー	まぐらー 〈道義をわきまえない者〉 【例】あ
まぐりーん	まぐりーん 〈（皮膚、着物、紙などが）しわ
ましし／ましさー	ましし／ましさー 〈赤肉〉 【例】ましし
まじむん	まじむん 〈積む〉【活】まじだん、まじまん、
まさいん	まさいん 〈勝る〉【活】まさたん、まさらん、
まさい うとぅるい	まさい うとぅるい 〈優劣〉 【例】まさ
まじゅん	まじゅん 〈一緒に〉 【例】しちぐゎち、そ
まさい むん	まさい むん 〈優れもの〉 【例】んかしか
まじん	まじん 〈束〉 【例】たむん たまじん（＝た
また ぬい	また ぬい 〈またがって乗ること〉 【例】
また〜	また〜〈無傷な、完全な〉 【例】たまー ち
また ばし ごーやく	また ばし ごーやく 〈二股かける者〉
また	また 〈また、再び〉 【例】また いちゃら 
また がらし	また がらし 〈又貸し〉 【例】からしぇー
また にーびち／また むち	また にーびち／また むち 〈再婚（主
また どぅめーい	また どぅめーい 〈再婚〉 【例】あぬ っ
また	また 〈股〉
まち	まち 〈市場〉 【例】やしぇーまち（野菜市）、
まち がしらー	まち がしらー 〈市の人気商品〉 【例】ぶ
まち がねー	まち がねー 〈場所使用料〉 【例】まちり
まち ばた	まち ばた 〈市場のそば〉 【例】いったー
また ぐし	また ぐし 〈股ぐら〉 【例】どぅく くぇ
まち や	まち や 〈店〉 【例】ぬーから ぬーまで
まちーん	まちーん 〈御霊を祀る〉【活】まちたん、まち
まちゃーすん	まちゃーすん 〈群がる、立ちこめる〉【活】
まちうちゅん	まちうちゅん 〈裏切る〉【活】まちうっちゃ
まちげー	まちげー 〈間違い、過失〉 【例】わーが 
まちゅん	まちゅん 〈蒔く、撒く〉【活】まちゃん、まか
まちげー ぐとぅ	まちげー ぐとぅ 〈道徳的に間違ったこ
まち ほーいん	まち ほーいん 〈まき散らす〉【活】〜ほー
まちぶいん	まちぶいん 〈からみつく、肉体関係をもつ〉
まちゅん	まちゅん 〈待つ〉【活】まっちゃん、またん、
まち あかすん	まち あかすん 〈待ち明かす〉【活】〜あか
まち うきーん	まち うきーん 〈待ち構える〉【活】〜うき
まっとーばー	まっとーばー 〈一徹者〉 【例】あれー 
まちゅん	まちゅん 〈巻く〉【活】まちゃん、まかん、ま
まっくゎ	まっくゎ 〈枕〉 【例】んかしぇー きーま
まったらー	まったらー 〈ツバメ〉 【例】まったらーや 
まちゃー	まちゃー 〈つむじ〉 【例】たーちまちゃー
まっ〜	まっ〜〈真〉
まっかーら	まっかーら 〈真っ赤〉 【例】うちなーぬ 
まっくーる	まっくーる 〈真っ黒〉 【例】がらさーや 
まっしーら	まっしーら 〈真っ白〉 【例】うちなーぬ 
〜までぃー	〜までぃー 〈無し〉 【例】くぬ くちゃぐ
まどぅ	まどぅ 〈暇、隙間〉 【例】しくちぬ いちゅ
まっちーる	まっちーる 〈真っ⻩色〉 【例】イッペーぬ
まどぅ なんか	まどぅ なんか 〈偶数目の法事〉 【例】ま
まどぅぬ むん	まどぅぬ むん 〈間食〉 【例】とぅく ま
まとぅまいん	まとぅまいん 〈まとまる〉【活】まとぅまた
まふっくゎ	まふっくゎ 〈真昼間〉 【例】まふっくゎね
まとぅみーん	まとぅみーん 〈まとめる、統一する〉【活】
まま	まま 〈言いなり〉 【例】あまぬ みーとぅんだ
まぶい	まぶい 〈魂〉 【例】まぶい／たまし ぬぎー
まぶい うてぃ／ぬぎ	まぶい うてぃ／ぬぎ 〈魂落ち〉 【例】
まぶい ぐみ	55 頁)。まぶい ぐみ 〈魂込め〉 【例】くるまじこ
まま	まま 〈一緒〉 【例】たーが ぬーんでぃ い
まま	まま 〈血縁関係のない、継〜〉 【例】ちょー
まぶい わかし	頁)。まぶい わかし 〈魂分かし〉 【例】しんじ
ままっくゎーすん	ままっくゎーすん 〈ごまかす〉【活】まま
まみぢゅん	まみぢゅん 〈まちがえる〉【活】まみぢゃん、
まやーすん	まやーすん 〈惑わす〉【活】まやーちゃん、ま
まむいん	まむいん 〈守る〉【活】まむたん、まむらん、
まむい がみ	まむい がみ 〈守り神〉 【例】あまぬ ま
まゆいん	まゆいん 〈迷う〉【活】まゆたん、まゆらん、
まるちゃ	まるちゃ 〈まな板〉 【例】んかしぇー は
まむこー	まむこー 〈真正面〉 【例】なかぐしくぐしく
まやー	まやー 〈猫〉 【例】まやーぬ ちら あらい
まやー ぐち	まやー ぐち 〈猫舌〉 【例】あれー ま
まる ばい	まる ばい 〈お尻まるだし〉 【例】んかし
まるみーん	まるみーん 〈丸める、心服させる〉【活】ま
まるむん	まるむん 〈まるくなる〉【活】まるだん、まる
まんぐぃーん	まんぐぃーん 〈うろたえる〉【活】まんぐぃ
まんじゅーうぃー	まんじゅーうぃー 〈パパヤ〉 【例】うち
まんきーん	まんきーん 〈混ぜる〉【活】まんきたん、ま
まん〜	まん〜〈全、万〉
まん だち すん	まん   だち   す ん 〈し っ か り 抱 擁 す る〉
まんぐら	まんぐら 〈あたり〉 【例】「やくそー まー
まんぐる	まんぐる 〈頃〉 【例】でぃーごー うりじ
まん だまし	まん だまし 〈魂のすべて〉 【例】あった
まん でー	まん でー 〈万代〉 【例】ゆーでーまんで
まん どーん	まん どーん〈多い〉【活】まんどーたん、い
まんぐゎすん	まんぐゎすん 〈惑わす〉【活】まんぐゎちゃ
まんちゃー ふぃんちゃー すん	まんちゃー ふぃんちゃー すん
まん ぶり すん	まん ぶり すん 〈完全に惚れてしまう〉
まんちゅん	まんちゅん 〈混じる〉【活】まんちゃん、ま
みー	みー 〈中、穴、ところ、時〉 【例】みーみーご
みー	みー 〈いっぱい〉 【例】わたぬ みー かだ
みー	みー 〈実〉 【例】みーぬ いらー くび を
みー	みー 〈目〉 【例】みーはぎ（ただれ目）、み
みー みー くーじー	みー みー くーじー 〈根掘り葉掘り〉
みー うすい	みー うすい 〈目隠し〉 【例】ちゃー う
みー くゎーすん	みー くゎーすん 〈間に合わせる〉【活】〜
みー うすいん	みー うすいん〈目をくらます〉【活】〜うす
みー じーんじーん すん	みー じーんじーん すん 〈目から火が
みー うち	みー うち 〈まばたき〉 【例】うむやー 
みーぬ くち	みーぬ くち 〈目がしら〉 【例】なだぬ 
みー くち	みー くち 〈表情〉 【例】ふぃるまさん 
みーぬ しん	みーぬ しん 〈目つき、目の芯〉 【例】が
みー くふぁくふぁー	みー くふぁくふぁー 〈寝つきの悪いさ
みーぬ ちび	みーぬ ちび 〈目尻〉 【例】あちはてぃ
みー とぅるばい	みー とぅるばい 〈唖然としているさま〉
みー くふぁいん	みー くふぁいん 〈目覚める〉【活】〜くふ
みー くふぁやー	みー くふぁやー 〈お目覚〉 【例】わらび
みー はい ぬすどぅ	みー はい ぬすどぅ 〈目の前で盗みをは
みー くらがん	みー くらがん 〈めまい〉 【例】てぃーだ
みー ふぃちゃいん	みー ふぃちゃいん 〈にらんで目を光らせ
みー こーがー	みー こーがー 〈疲れで目がくぼむこと〉
みー まゆ	みー まゆ 〈顔立ち〉 【例】わん どぅし
みー いり	みー いり 〈新入り〉 【例】くとぅしぬ 
みー むとぅ	みー むとぅ 〈目もと〉 【例】うぬ っち
みー にし	みー にし 〈新北風〉 【例】うちなーぐゆ
みー ふぁー ふぁー	みー ふぁー ふぁー 〈呆然としているさ
みー むん	みー むん 〈新品〉 【例】くぬ かばのー
みー よー	みー よー 〈目くばせ〉【活】みー よー 
みー やみ	みー やみ 〈眼病〉 【例】ななじゅーぐれ
みー いんでー	みー いんでー 〈ものもらい〉 【例】にぢ
みーじーくーじー／ごーぐちはーぐち すん	みーじーくーじー／ごーぐちはーぐち すん 〈ぶつぶつ不平を言う〉
みーとぅんだ	みーとぅんだ 〈夫婦〉 【例】みーとぅんだ
みーとぅんだ おーえー	みーとぅんだ おーえー 〈夫婦げんか〉
みーとぅんだ ぐゎー しぇー	みーとぅんだ ぐゎー しぇー 〈夫婦ご
みーばい	みーばい 〈めばる〉 【例】みーばいやか 
みー〜	みー〜〈新〉 【例】みーぢん（新しい服）、みー
みー むん／みー むなー	みー むん／みー むなー 〈雌〉
みーゆん	みーゆん 〈生える〉【活】みーたん、みーら
みー けーし げーし	みー けーし げーし 〈くり返し見るこ
みー かーい ばー	みー かーい ばー 〈永久⻭〉 【例】み
みー くーめー	みー くーめー〈にらめっこ〉 【例】「みー
みーゆん	みーゆん 〈見える〉【活】みーたん、みーら
みー さぎーん	みー さぎーん 〈見下げる〉【活】〜さぎた
みー あてぃーん	みー あてぃーん 〈見つける〉【活】〜あて
みー しーん	みー しーん 〈顔見知りになる、見知る〉
みー うじー	みー うじー 〈見ただけで怖じ気づくこと〉
みー してぃーん	みー してぃーん 〈見捨てる〉【活】〜して
みー うびーん	みー うびーん 〈見覚えがある〉【活】〜う
みー くんだー	みー くんだー 〈見ても何だかわからない
みー ちーん	みー ちーん 〈見切りをつける〉【活】〜ちっ
みー なり ちち なり	みー なり ちち なり 〈見たり聞いた
みー ないん	みー ないん 〈見定める〉【活】〜なたん、〜
みー ぬがらすん	みー ぬがらすん 〈見逃してやる〉【活】〜
みー むん	みー むん〈催しもの〉 【例】ちゅーや み
みー はてぃーん	みー はてぃーん 〈見終わる〉【活】〜はて
みー やんぢゅん	みー やんぢゅん〈見損なう、見誤る〉【活】〜
みー ばっぺーいん	みー ばっぺーいん 〈見間違う〉【活】〜ば
みー はんだー	みー はんだー 〈期待はずれ〉 【例】ゐー
みー まんぢゅん	みー まんぢゅん 〈見守る〉【活】〜まんた
みうくいん	みうくいん 〈見送る〉【活】みうくたん、み
〜みかすん	〜みかすん 〈〜という音をたてる〉【活】〜み
みぐいん	みぐいん 〈廻る〉【活】みぐたん、みぐらん、
みぐ い	みぐ い 〈めぐり〉 【例】ふぃーみぐい（日
みじ	みじ 〈水〉 【例】ぬすどー むっちいかりー
みし ちぢ	みし ちぢ 〈飯粒〉 【例】めーまかいぬ み
みぐ らすん	みぐ らすん 〈巡らす、回す〉【活】みぐら
みじゅん	みじゅん 〈イワシ〉 【例】んかしぇー みじ
みくち	みくち 〈御骨〉 【例】ふるばかから みーば
みちーん	みちーん 〈閉める、満たす〉【活】みちたん、
みしーん	みしーん 〈見せる〉【活】みしたん、みしらん、
みしげー	みしげー 〈しゃもじ〉 【例】うちなーぐちぬ
みちくみーん	みちくみーん 〈閉じ込める〉【活】みちくみ
みち ばっぺー	みち ばっぺー 〈道で迷うこと〉 【例】
みしがら	みしがら 〈身一つ〉 【例】ありんくりん 
みちゅん	みちゅん 〈満つ〉【活】みっちゃん、みたん、
みみ	みみ 〈耳〉 【例】いちむしぇー くぃー か
みみ がー	みみ がー 〈（豚の）耳皮〉 【例】みみがー
みち すー	みち すー 〈満潮〉 【参】ふぃち すー。
みっくゎー	みっくゎー 〈盲人〉【活】＝みーぬ ふじゆ
みっくゎさ すん	みっくゎさ すん 〈憎い〉【活】〜さん、〜
みっちゃ	みっちゃ 〈三日〉 【例】うぬ くすいぬ 
みっちゃい	みっちゃい 〈三人〉 【例】みっちゃい す
みみ くじやー	みみ くじやー 〈耳かき〉 【例】あまんか
みみぬ ふぁー	みみぬ ふぁー 〈耳全体〉 【例】みみぬ
みん くじらー	みん くじらー 〈耳がわるい者〉 【例】わ
みみがに	みみがに 〈理解力〉 【例】みみがにぬ あ
みみじゃー	みみじゃー 〈ミミズ〉 【例】っやーが か
みっちゃかいん	みっちゃかいん 〈満ちる〉【活】みっちゃ
みみぢゅん	みみぢゅん 〈揉む〉【活】みみぢゃん、みみ
みんぐゎすん	みんぐゎすん 〈かき回す〉【活】みんぐゎち
みむち	みむち 〈身持ち〉 【例】あぬ っちょー く
みんくゎーうー	みんくゎーうー 〈作り顔〉 【例】わらび
みるく	みるく 〈弥勒〉 【例】みるくぬ うかみがな
みんさー	みんさー 〈布の一種〉 【例】うーべー み
みゅんち	みゅんち 〈お顔〉 【例】あやかいぶさいび
みんちゃむん	みんちゃむん 〈目に入ったゴミ〉 【例】み
みんな	みんな 〈るりはこべ〉 【例】ふぃーじゃーぬ
みんぐぃーん	みんぐぃーん 〈濁る〉【活】みんぐぃたん、
むいん	むいん 〈漏れる〉【活】むたん、むらん、むて
むい にんしーん	むい にんしーん 〈守りをして寝かせる〉
むーちー びーさ	むーちー びーさ 〈むーちー（⻤餅）寒
むいん	むいん 〈もぎ取る〉【活】むたん、むらん、む
むえー	むえー 〈模合〉 【例】ちちむえーや ちゅち
むいん	むいん 〈盛る〉【活】むたん、むらん、むてぃ
むいん	むいん 〈子守りをする〉【活】むたん、むらん、
むくい	むくい 〈恩恵、報い〉 【例】あまぬ うやふ
むげーいん	むげーいん 〈沸騰する〉【活】むげーたん、む
むさげーいん	むさげーいん 〈にぎやかに騒ぐ〉【活】むさ
むじゅむじゅー すん	むじゅむじゅー すん 〈むずむずする〉
むし	むし 〈もし〉 【例】ありんかい っしとぅら
むすび くーぶ	むすび くーぶ 〈結び昆布〉 【例】むす
むし	むし 〈虫〉 【例】ありんかえー にーぶやー
むたぶん	むたぶん 〈遊びをする〉【活】むただん、むた
〜むたーん	〜むたーん 〈〜遊び〉 【例】わらべー ど
むし くぇー ばー	むし くぇー ばー 〈虫⻭〉 【例】むし
むじ くじ	むじ くじ 〈ものの道理〉 【例】しめー 
むじゃらくゎじゃら すん	むじゃらくゎじゃら すん 〈うじゃ
むち	むち 〈餅〉 【例】じゅーぐやーに あかまー
むちとぅ かーさ	むちとぅ かーさ 〈男女の親密な関係〉
むち	むち 〈漆喰〉
むち ちちゃー	むち ちちゃー 〈漆喰作りの職人〉 【例】
むちめー	むちめー 〈独特〉 【例】うちなーぬ なー
むぢゅくいん	むぢゅくいん 〈（芽や蕾が）できかかる〉
むぢゅく い	むぢゅく い 〈農作物〉 【例】なちぬ 
むちゅん	むちゅん 〈持つ〉【活】むっちゃん、むたん、
むち にー	むち にー 〈手荷物〉 【例】ひこーじょー
むち のーすん	むち のーすん 〈持ち直す〉【活】〜のーち
むち はんでぃーん	むち はんでぃーん 〈持ち崩す〉【活】〜は
むち くゎいん	むち くゎいん 〈引きずり込む〉【活】〜く
むち ばんめー	むち ばんめー 〈弁当〉 【例】しくち ふ
むち すく	むち すく〈位牌の守り主〉 【例】むちすこ
むち めー	むち めー 〈負担額〉 【例】ちゅいなー 
むち っくゎ	むち っくゎ 〈負担加重〉 【例】どぅーぬ
むち んちゅん	むち んちゅん 〈持ち込む〉【活】〜んちゃ
むち なし	むち なし 〈手入れ〉 【例】んかしぬ で
むち っんぶさ	むち っんぶさ 〈気が重いこと〉 【例】っ
むちりーん	むちりーん 〈くっつき合う〉【活】むちりた
むでぃ けーらすん／むでぃ とーす	むでぃ けーらすん／むでぃ とーす
ん	ん〈ひねり倒す〉【活】むでぃけーらちゃん／む
むっくー	むっくー 〈形状が小さいもの〉 【例】くま
むっちゃかいん	むっちゃかいん 〈くっつく〉【活】むっち
むてぃわかすん	むてぃわかすん 〈特別待遇する〉【活】む
むてーいん	むてーいん 〈盛んになる〉【活】むてーたん、
むっちょーふぃっちょー すん	むっちょーふぃっちょー すん 〈も
むてーい さけーい すん	む て ー い   さ け ー い   す ん 〈栄 え る〉
むてぃ	むてぃ 〈方角〉 【例】いったー やーや み
むとぅ	むとぅ 〈もとで、元金、元〉 【例】やしうい
むでぃーん	むでぃーん 〈ひねる〉【活】むでぃたん、む
〜むとぅ	〜むとぅ 〈（生えている竹の）〜本〉 【例】ち
むどぅるちゅん	むどぅるちゅん 〈視力が衰える、ためら
むどぅいん	むどぅいん 〈戻る〉【活】むどぅたん、むど
むぬ	むぬ 〈もの、ことば〉 【例】むのー うさが
むどぅすん	むどぅすん 〈戻す〉【活】むどぅちゃん、む
むどぅちゅん	むどぅちゅん 〈さからう〉【活】むどぅちゃ
むとぅーいん	むとぅーいん 〈⻑続きする〉【活】むとぅー
むにー	むにー 〈もの言い〉 「むぬ いー」から３
むとぅーすん	むとぅーすん 〈⻑続きさせる〉【活】むとぅ
むぬ いー ぐぃー	むぬ いー ぐぃー 〈話し声〉 【例】ま
むぬ いー じょーじ	むぬ いー じょーじ 〈話上手〉 【例】
むとぅ びれー（ぐゎー）	むとぅ びれー（ぐゎー）〈元恋人〉
むぬ いー たなり	むぬ いー たなり〈ものの言い方〉 【例】
むぬ いー はじみ	むぬ いー はじみ 〈ことばを話始めるこ
むぬ いりみ／っんぢり めー	むぬ いりみ／っんぢり めー 〈収入／
むぬ わしー	むぬ わしー 〈もの忘れ〉 【例】あれー 
むぬ われー	むぬ われー 〈もの笑い〉 【例】っちゅん
むぬ うじ	むぬ うじ 〈もの怖じ〉 【例】あれー ま
むん ぬき むん	むん ぬき むん 〈魔除け〉 【例】シーサ
むぬ うび	むぬ うび 〈記憶力〉 【例】ちかぐろー 
むぬ うみー	むぬ うみー 〈思いつめること〉 【例】あ
むぬ	むぬ 〈道理〉 【例】あれー むのー うまー
むぬ あかしぇー	むぬ あかしぇー 〈謎解き〉 【例】むぬあ
むぬ くくん あびー	むぬ くくん あびー 〈ふくみ声〉 【例】
むぬ かんげー	むぬ かんげー 〈筋道をたてて考えること〉
むぬ じち	むぬ じち 〈もの好き〉 【例】うさきなー
むん ならーし	むん ならーし 〈しつけること〉【活】むん
むぬ まいー	むぬ まいー 〈神隠し〉 【例】むぬまいー
むぬ	むぬ 〈食べ物〉 【例】なげー くちにーさた
むぬ ゆまー	むぬ ゆまー 〈おしゃべり〉 【例】っやー
むぬ くーい	むぬ くーい 〈物乞い〉【活】むぬ くーや
むんぬ ゆく	むんぬ ゆく 〈食欲〉 【例】なちぇー あ
むぬ ぐし	むぬ ぐし 〈食べ物の好き嫌い〉 【例】あ
むむ	むむ 〈腿〉 【例】わかさる じぶのー むむ
むぬ ぐし すん	むぬ ぐし すん 〈食べ物の好き嫌いをす
むぬ ふさ すん	むぬ ふさ すん 〈もの欲しそうにする〉
むむとぅ	むむとぅ 〈百年、百歳〉 【例】っやーとぅ
むむん	むむん 〈もめる〉【活】むだん、むまん、むでぃ
むるさー げーやー すん	むるさー げーやー すん 〈ごろご
むぬ じぶん	むぬ じぶん 〈食事時間〉【活】むぬ いみ
むるし げーいん	むるし げーいん 〈かたまりができる〉
むぬ すがい	むぬ すがい 〈食事の支度〉 【例】むぬす
むんぬ ごーぐち	むんぬ ごーぐち 〈食べ物の不平不満〉
むる のーい	むる のーい 〈全快〉 【例】どぅー あん
むん	むん 〈もの、道理、食べ物〉 【例】「むぬ」の縮
むん だに	むん だに 〈餌食〉 【例】むんだにんかい
むん	むん 〈よ（終助詞）〉 【例】えーじ しーねー
むん がたい じち	むん がたい じち 〈話好き〉 【例】わ
むんちゅー じゅりー	むんちゅー じゅりー 〈一門の集まり〉
むん がりー	むん がりー 〈飼料〉 【例】っわーぬ 
むん ぐん	むん ぐん 〈文言〉 【例】むんぐん かち
むんちゅー ばか	むんちゅー ばか 〈門中墓〉 【例】うし
むんどー	むんどー 〈問題、けんか〉 【例】ありが 
むん ざーい	むん ざーい 〈蕁麻疹〉 【例】あったに
めー	めー 〈前〉 【例】いったー やーぬ めーん
めー ごーい	めー ごーい 〈前もって買うこと〉 【例】
めー しらし	めー しらし 〈前兆〉 【例】でぃーぐぬ 
めー あが いん	めー あが いん 〈増⻑する〉 【参】めー
めー あがい すん	めー あがい すん 〈増⻑する〉【活】〜さ
めー ちんたー すん	めー ちんたー すん 〈前につんのめるこ
めーない ない すん	めーない ない すん〈でしゃばる〉【活】〜
めー がい すん	めー がい すん 〈前借りする〉【活】〜さ
めー ばー	めー ばー 〈前⻭〉 【例】どぅく まーさ
めー かに よーじょー	めー かに よーじょー 〈予防〉 【例】
めー ばれー	めー ばれー 〈前払い〉 【例】てぃまー 
めー	めー 〈飯米〉 【例】めーぬ まーさる まか
めー	めー 〈毎〉 【例】めーあさ ふぇーうきっし
めー	めー 〈枚（着物、紙、お札を数える単位）〉
めーさー	めーさー 〈燃料〉 【例】めーさーや たむ
〜めー	〜めー 〈お金〉 【例】ちゅいなー ちゅい
めーさー	めーさー 〈おべっかを使う者〉 【例】うぃ
〜めー	〜めー 〈尊敬辞〉 【例】んかしぇー をーん
めーいん	めーいん 〈燃える〉【活】めーたん、めーら
めーうぃきが	めーうぃきが 〈紳士、殿がた〉 【例】めー
めーし／うめーし	めーし／うめーし 〈箸〉 【例】てぃーん
めーすん	めーすん 〈燃やす〉【活】めーちゃん、めーさ
もー	もー 〈野〉 【例】わったー はろー うっち
もーきーん	もーきーん 〈もうける〉【活】もーきたん、も
もー いちゅび	もー いちゅび 〈野いちご〉 【例】もーい
〜もー	〜もー 〈無し〉 【例】てぃーもー（手がない
もーき じゅく	もーき じゅく 〈アルバイト、儲け一本槍〉
もーいん	もーいん 〈（即興的に）踊る〉【活】もーたん、
もーしゃぎ	もーしゃぎ 〈告げ口〉 【例】もーしゃぎ 
もーいん	もーいん 〈行く、来る（敬語）〉【活】もーち
もーどー	もーどー 〈心が乱れるさま〉 【例】あった
やー	やー 〈家、屋〉 【例】あしじゃやー（下駄屋）、
やー うーちー	やー うーちー 〈引っ越し〉 【例】やくど
やー うち	やー うち 〈内々の〉 【例】やーうちぬ 
やー ぐなー	やー ぐなー 〈家族〉 【例】やーんかい 
やー ぐま やー	やー ぐま やー 〈家にこもって出歩かな
やー いぢゃー	やー いぢゃー 〈内弁慶〉 【例】ふかん
やー じしー	やー じしー 〈家に慣れないさま〉 【例】
やー たちゃー／やー わかやー	やー たちゃー／やー わかやー 〈分家
やー どぅい	やー どぅい 〈都落ちをした士族の集落〉
やー なれー	やー なれー 〈家でのしつけ〉 【例】やー
やーぬ ぬーし	やーぬ ぬーし 〈家主〉 【例】まぎくーば
やーぬ ばーん	やーぬ ばーん 〈留守番〉 【例】しらんち
やーさ	やーさ 〈ひもじいこと〉 【例】やーさ まー
やーさ がみー	やーさ がみー〈がつがつ食うこと〉 【例】
やーさ じに	やーさ じに 〈飢え死に〉 【例】ゆぬなか
やーさ のーし	やーさ のーし〈空腹の一時しのぎ〉 【例】
やーどぅー、やーるー	やーどぅー、やーるー 〈ヤモリ〉 【例】
やいん	やいん 〈破る〉【活】やたん、やらん、やてぃ
やー むちゃー	やー むちゃー 〈しっかり家計を支えてい
やー ん なー	やー ん なー 〈屋号〉 【例】いったー 
やい ほーいん	やい ほーいん 〈ずたずたに破る〉【活】〜
やきーん	やきーん 〈焼ける〉【活】やきたん、やきら
やか	やか 〈より〉 【例】あり やか くれー ま
やから／やからむん	やから／やからむん 〈しっかり者、頼り
やく	やく 〈役〉 【例】くち ぱくぱくーや／くち
やぐさみむん	やぐさみむん 〈未亡人〉 【例】やぐさみ
やぐみさ	やぐみさ 〈恐れ多いこと〉 【例】やぐみさ
やゑーさに？	やゑーさに？〈〜ではないか（確認）〉 【例】
やしぇー	やしぇー 〈野菜〉 【例】むぬ かむる ば
やく	やく 〈厄〉 【例】やーぬうちんかい とぅび
やし がるー	やし がるー 〈痩せてほっそりしている子、
やし ごーい	やし ごーい 〈安く買うこと〉 【例】た
やち むん	やち むん 〈陶器〉 【例】んかしぬ やー
やしないん	やしないん 〈養う〉【活】やしなたん、やし
やしない んぐゎ	やしない んぐゎ 〈養子〉 【例】うちなー
やしむん	やしむん 〈休む〉【活】やしだん、やしまん、
やちりーん	やちりーん 〈やつれる〉【活】やちりたん、や
やっくゎ	やっくゎ 〈高木の上の物見やぐら〉 【例】な
やすんじーん	やすんじーん 〈許してあげる、あきらめる〉
やっくゎん	やっくゎん 〈やかん〉 【例】ちび あちら
やっけー	やっけー 〈世話、困ったこと〉 【例】っちゅ
やちゅん	やちゅん 〈焼く〉【活】やちゃん、やかん、や
やっちー	やっちー 〈兄さん（士族）〉 【例】あまぬ 
やっぱいん	やっぱいん 〈踏ん張る〉【活】やっぱたん、や
やな がたー	やな がたー 〈悪い形のもの〉 【例】うれ
やな がんまり すん	やな がんまり すん 〈ふざける〉 【例】
やな むん	やな むん 〈嫌なやつ、悪霊〉 【例】とぅ
やとぅ〜	やとぅ〜〈特大な〜〉 【例】やとぅ むち（特
やとぅ まぎさん	やとぅ まぎさん 〈巨大である〉
やとぅ まぎー	やとぅ まぎー 〈巨大なもの〉
やどぅいん	やどぅいん 〈宿泊する〉【活】やどぅたん、や
やにーん	やにーん 〈竹を細く削る〉【活】やにたん、や
やどぅ ちん	やどぅ ちん 〈宿泊代〉 【例】やどぅちん
やびりーん	やびりーん 〈体が弱くなる、衰弱する〉【活】
やな〜	やな〜〈嫌、悪〉 【例】やなー（上等ではない
やびり むん／やびらー	やびり むん／やびらー 〈体が弱い者〉
やふぁた ぐさ	やふぁた ぐさ 〈紫カタバミ〉 【例】ん
やふぁらちゅん	やふぁらちゅん 〈やわらくなる、体が弱
やふぁらきーん	やふぁらきーん 〈やわらくする、和解させ
やま んかぢ	やま んかぢ 〈サソリ〉 【例】やまんかぢ
やま かーがー	やま かーがー 〈人見知りの者〉 【例】＝
やま1	やま 1 〈森林〉 【例】やま あっちゃー（林業従事者）。やま あっちゅん。（林業に従事す
やま2	やま 2 〈逸脱した状態〉 （人に対して）非嫡出、乱暴；（物に対して）非認可；（状況に対し
やま ぐー	やま ぐー 〈乱暴者〉 【例】＝ぼーちらー、
やま あったみ	やま あったみ〈イノシシの肉〉 【例】「い
やますん	やますん 〈ケガをする、傷つける〉【活】やま
やまとぅ	やまとぅ 〈大和、本土日本〉 【例】やまと
やまとぅ ぐゆみ	やまとぅ ぐゆみ 〈新暦〉 【例】うちなー
やまとぅ じふぇー	やまとぅ じふぇー 〈本土日本人の気の早
やみ ち	やみ ち〈病み気〉 【例】どぅーぬ いふな
やん	やん 〈痛み〉 金城（1997, 71-72 頁）には、次
やみーん	やみーん 〈やめる〉【活】やみたん、やみら
やむん	やむん 〈止む〉【活】やだん、やまん、やでぃ
やむん	やむん 〈痛める、病む〉【活】やだん、やまん、
やらすん	やらすん 〈遣らす、行かせる〉【活】やらちゃ
やりーん	やりーん 〈（着物や紙が）破れる〉【活】やり
やんでぃーん	やんでぃーん 〈（物、道具が）壊れる、破れ
やんぢゅん	やんぢゅん 〈こわす、だめにする、破る〉【活】
やんばる ぶに	やんばる ぶに 〈ヤンバル船〉 【例】い
やんむち	やんむち 〈鳥モチ〉 【例】やんむちぇー き
〜やんぢゅん	〜やんぢゅん 〈〜そこなう〉【活】〜やんぢ
やんめー	やんめー 〈病気〉 【例】わんねー やんめー
っやー	っやー 〈お前、君〉 【例】っやー むのー 
っやー くる／っやん くる	っやー くる／っやん くる 〈あなた自
ゐー	ゐー 〈結い〉
ゐーん	ゐーん 〈坐る〉【活】ゐちゃん、ゐらん、ゐち
ゐー まーるー	ゐー まーるー 〈助け合い〉 【例】んか
ゐー〜	ゐー〜〈良い〉 【例】ゐーばー（良い機会）、ゐ
ゐー ちちゅん	ゐー ちちゅん〈適応して落ち着く〉【活】〜
ゐー ぐくち	ゐー ぐくち 〈いい心地〉 【例】むいぬ 
ゐぬ	ゐぬ 〈同じ〉 いも（同妹）、いもせ（同背）に
ゐー にーぶい	ゐー にーぶい 〈座ったままの居眠り〉
ゐーゆん	ゐーゆん 〈もらう、もてあそぶ〉【活】ゐーた
ゐしーん	ゐしーん 〈据え置く／落ち着かせる〉【活】 
ゐん	ゐん 〈縁故、ゆかり〉 【例】っやーとぅ わん
ゐーり むん	ゐーり むん 〈玩具、もらい物〉 【例】ゆ
ゆい	ゆい 〈ユリ〉 【例】めーにん いーじまをぅ
ゆいん	ゆいん 〈地震が起こる、寄る〉【活】ゆたん、ゆ
ゆー	ゆー 〈夕、夜〉
ゆー がらさー	ゆー がらさー 〈夜ガラス〉 【例】がらさ
ゆー	ゆー 〈世〉 【例】ゆーや してぃてぃん み
ゆーき	ゆーき 〈夜更かし〉 【例】わかさる うちぇ
ゆー	ゆー 〈湯〉 【例】ゆーんかい ちかいねー、を
ゆー まんぐぃ、ゆまんぐぃ	ゆー まんぐぃ、ゆまんぐぃ 〈夕暮れ時〉
ゆー ふる	ゆー ふる 〈風呂〉 【例】してぃみてぃ 
ゆっくゎすん	ゆっくゎすん 〈夜を明かす〉【活】ゆっくゎ
ゆー げーら すん	ゆー げーら すん 〈火傷する〉【活】〜げ
ゆっくぃーん	ゆっくぃーん 〈夜が暮れる〉【活】ゆっくぃ
ゆーゆー	ゆーゆー 〈鶏（小児語）〉 【例】ゆーゆーぐ
ゆさんでぃ	ゆさんでぃ 〈夕方暗くなる頃〉 【例】ゆさ
ゆさんでぃ あけーい	ゆさんでぃ あけーい〈夕焼け〉 【例】ゆ
ゆながた／ゆながたさながた	ゆながた／ゆながたさながた 〈夜通し〉
ゆかいん	ゆかいん 〈作物がよくできる、生い茂る〉【活】
ゆかさ	ゆかさ 〈床下〉 【例】んかしぇー からゆか
ゆーいん	ゆーいん 〈結う〉【活】ゆたん、ゆらん、ゆて
ゆーちら	ゆーちら 〈徳、役〉 【例】っやーや ゆー
ゆがふー	ゆがふー 〈豊年満作の年、世果報〉 【例】し
ゆーな	ゆーな 〈オオハマボウ〉 【例】ゆーなぬ は
ゆがみーん	ゆがみーん 〈ゆがめる〉【活】ゆがみたん、ゆ
ゆかる	ゆかる 〈佳き〉 【例】とぅしびー やくとぅ、
ゆくし むにー	ゆくし むにー 〈嘘つき（行為）〉 【例】ゆ
ゆく／ゆーく	ゆく／ゆーく 〈欲〉 【例】どぅー むち
ゆくし むにー さー	ゆくし むにー さー 〈嘘つき（者）〉
ゆく	ゆく 〈横〉
ゆくいん	ゆくいん 〈休む〉【活】ゆくたん、ゆくらん、
ゆくゎーすん	ゆくゎーすん 〈休ませる〉【活】ゆくゎーち
ゆくい どぅくる	ゆくい どぅくる 〈休憩所〉 【例】やんば
ゆく ぬーでぃー	ゆく ぬーでぃー 〈気管〉 【例】むぬぬ 
ゆく むにー	ゆく むにー〈横から口出すこと、はぐらか
ゆく ばい すん	ゆく ばい すん 〈逸れる〉 【例】あれー
ゆくすん	ゆくすん 〈誘う〉【活】ゆくちゃん、ゆくさ
ゆくねー	ゆくねー 〈夜中〉 【例】ゆくねー ぐらしん
ゆくし	ゆくし 〈嘘〉 【例】あかゆくさー／そーゆく
ゆくらすん	ゆくらすん 〈休ませる〉【活】ゆくらちゃん、
ゆぐすん	ゆぐすん 〈汚す〉【活】ゆぐちゃん、ゆぐさ
ゆし どーふ	ゆし どーふ 〈おぼろ豆腐〉 【例】ちゅ
ゆぐりーん	ゆぐりーん 〈汚れる〉【活】ゆぐりたん、ゆ
ゆぐり むん	ゆぐり むん 〈汚れ物〉 【例】ゆぐりむの
ゆじーん	ゆじーん 〈譲る〉【活】ゆじたん、ゆじらん、
ゆしぢゅん	ゆしぢゅん 〈ゆすぐ〉【活】ゆしぢゃん、ゆ
ゆし あし	ゆし あし 〈善し悪し〉 【例】むぬぐとぅ
ゆしむん	ゆしむん 〈立ち止まる、思いとどまる〉【活】
ゆしーん	ゆしーん 〈諭す、忠告する〉【活】ゆしたん、
ゆし ぐとぅ	ゆし ぐとぅ 〈諭すことば、教訓〉 【例】
ゆしみーん	ゆしみーん 〈立ち止まらせる、思いとどませ
ゆしーん	ゆしーん 〈寄せる〉【活】ゆしたん、ゆしらん、
ゆしりーん	ゆしりーん 〈寄って来る〉【活】ゆしりたん、
ゆっかぬ ふぃー	ゆっかぬ ふぃー 〈旧暦 5 月 4 日〉 【参】
ゆす	ゆす 〈他所〉 【例】ゆすたにん やてぃん い
ゆすぬ みー／ゆすみ	ゆすぬ みー／ゆすみ 〈他人の目〉 【例】
ゆったいくゎったい すん	ゆったいくゎったい すん 〈だぶん
ゆてぃーん	ゆてぃーん 〈こぼす〉【活】ゆてぃたん、ゆ
ゆだ	ゆだ 〈枝〉 大和古語の「よ」と、「万朶の桜」
ゆてぃりーん	ゆてぃりーん 〈こぼれる〉【活】ゆてぃりた
ゆでぃーん	ゆでぃーん 〈ゆでる〉【活】ゆでぃたん、ゆ
ゆだい	ゆだい 〈よだれ〉 【例】くさりむんぬ ゆだ
ゆにぬ うゆうぇー	ゆにぬ うゆうぇー 〈米寿（88 歳）のお祝い〉 【参】とーかちぬ うゆうぇー（85 歳
ゆだい じーじー	ゆだい じーじー 〈生唾が出てきているさ
ゆたみちゅん	ゆたみちゅん 〈揺れ動く〉【活】ゆたみちゃ
ゆぶん	ゆぶん 〈呼ぶ〉【活】ゆだん、ゆばん、ゆでぃ
ゆみ	ゆみ 〈嫁〉 【例】うちなーをぅてー ゆみど
ゆみ いびらー	ゆみ いびらー 〈嫁いびりする姑〉 【例】
ゆらいん	ゆらいん 〈分け合う〉【活】ゆらたん、ゆらー
ゆむん	ゆむん 〈読む、数える、詠む〉【活】ゆだん、ゆ
ゆむん	ゆむん 〈悪口を言う〉【活】ゆだん、ゆまん、ゆ
ゆらりーん	ゆらりーん 〈集まる〉【活】ゆらりたん、ゆ
ゆるじな くとぅ	ゆるじな くとぅ 〈余計なこと〉 【例】
ゆるじな むん	ゆるじな むん 〈間食〉 【例】っやーや
ゆるみーん	ゆるみーん 〈緩める、放す〉【活】ゆるみた
ゆれー	ゆれー 〈模合い〉 【例】わんねー くじ や
ゆゆ／ゆい	ゆゆ／ゆい 〈節から節までの間〉 【例】大
ゆれーいん	ゆれーいん 〈寄り合う、集まる〉【活】ゆれ
ゆんたー うぃなぐ、ゆんたー ふぃんたー うぃなぐ	ゆんたー うぃなぐ、ゆんたー ふぃんたー うぃなぐ 〈おしゃべり
ゆんたく	ゆんたく 〈おしゃべり〉
ゆんたくー	ゆんたくー 〈おしゃべり好き〉 【参】ゆん
ゆんかんしーん／ゆみかんしーん	ゆんかんしーん／ゆみかんしーん
よーいん	よーいん 〈弱る〉【活】よーたん、よーらん、
よーがりーん	よーがりーん 〈痩せる〉【活】よーがりた
よーがり むん	よーがり むん 〈痩せっぽち〉 【例】あ
よーし	よーし 〈様子、容態〉 【例】ちゃぬ ふーじ
よーい むん	よーい むん 〈弱ったもの〉 【例】くぬ 
よーがー	よーがー 〈歪んだもの、まがったもの〉 【例】
よーそーいん	よーそーいん 〈かまわずにいる〉【活】よー
よーがー ふぃーがー すん	よーがー ふぃーがー すん 〈曲がって
よーそーちゅん	よーそーちゅん 〈やめておく〉【活】よー
よーか びー	よーか びー 〈旧暦 8 月 8 日の厄よけ〉【例】よーかびーねー やしちぬ うがみん う
よーばー	よーばー 〈弱虫〉 【例】ゐぬ っちゅどぅ 
よーみ	よーみ 〈弱いところ〉 【例】わん くるま
〜らーさ	〜らーさ 〈らしさ〉 【例】うちなーらーさ
りー	りー 〈利息〉 【例】たかりーとぅやーぬ じ
りーぢ さふー	りーぢ さふー 〈礼儀作法〉 【例】まちげ
りー	りー 〈霊〉
〜りかー	〜りかー 〈〜のあたり〉 【例】いゆまちぇ
りー じん／ぐ りー じん	りー じん／ぐ りー じん 〈御霊前〉
りくち	りくち 〈ずる賢いこと〉 【例】さき ぬまー
りーち	りーち 〈茘枝〉 【例】りーちぇー とーから
りーぢ	りーぢ 〈礼儀〉 【例】なまぬ わかむのー 
りーぢ げーし	りーぢ げーし 〈贈り物のお返し〉 【例】
りくちゃー	りくちゃー 〈ずる賢い人〉 【例】あれー 
〜りば、〜れー	〜りば、〜れー 〈条件、已然〉 【例】ちゃ
りんち	りんち 〈嫉妬〉 【例】どぅーやか すぐりた
〜りわ、〜らー	〜りわ、〜らー 〈条件、未然〉 【例】ち
りんくゎー	りんくゎー 〈防寒用の着物の一種〉 【例】
るー／どぅー	るー／どぅー 〈龍〉 【例】るーや るー
るぐゎい／どぅぐゎい	るぐゎい／どぅぐゎい 〈アロエベラ、⻯
るーか	るーか 〈琉歌〉 【例】るーかー るーちゅー
るーちゅー／どぅーちゅー	るーちゅー／どぅーちゅー 〈琉球〉
ろー	ろー 〈ロウソク〉 【例】うふかじに でんきぬ
ろーま	ろーま 〈もうろく〉 【例】っちょー むる 
わー／わん	わー／わん 〈私〉 【例】わんにんかい（私
わかさ い に	わかさ い に 〈若い時〉 【例】わかさい
わか じーら	わか じーら 〈産後の浅いからだ〉 【例】
わー どぅー	わー どぅー 〈我が身〉 【例】ぬちぇー 
わん くる	わん くる 〈私自身で〉 【例】どぅーぬ 
わーきー	わーきー 〈分け前〉 【例】ちゅくい わー
わか しらぎ	わか しらぎ 〈若白髪〉 【例】わかしらげ
わか なち	わか なち 〈若夏〉 【例】すーまんぼーす
わか みじ	わか みじ 〈若水〉 【例】そーぐゎちねー
わか〜	わか〜〈若〉 【参】「わかさん」（若い）からの
わか げー いん	わか げー いん 〈若返る〉【活】わかげー
わか むん	わか むん 〈若者〉 【例】なまぬ わかむ
わか うぃなぐ	わか うぃなぐ 〈若い女性〉【活】わか う
わかりーん	わかりーん 〈別れる〉【活】わかりたん、わ
わかり	わかり 〈別れ〉 【例】わかりぬ しからーさ
わかり あちさ	わかり あちさ 〈最後の暑さ〉 【例】ちぬ
わかいん	わかいん 〈わかる〉【活】わかたん、わから
わかり びーさ	わかり びーさ 〈余寒〉 【例】うちなーぬ
わかいん	わかいん 〈分かれる〉【活】わかたん、わから
わかすん	わかすん 〈沸かす〉【活】わかちゃん、わかさ
わかすん	わかすん 〈分ける〉【活】わかちゃん、わか
わごー、まるみ	わごー、まるみ 〈和〉 【例】おーえーむ
わさわさ すん	わさわさ すん 〈がやがやする〉【活】〜さ
わじゃうぇー	わじゃうぇー 〈災い〉 【例】くちぇー 
わじら わじら すん	わじら わじら すん 〈今にも怒りそ
わさみちゅん	わさみちゅん 〈騒ぐ〉【活】わさみちゃん、
わじゃむん	わじゃむん 〈しわがよる、しかめっつらにな
わしーん	わしーん 〈忘れる〉【活】わしたん、わしら
わじゃみーん	わじゃみーん 〈しわをよせる〉【活】わじゃ
わじーん	わじーん 〈腹をたてる、怒る〉【活】わじた
わじわじ すん	わじわじ すん 〈腹をたてる、怒る〉【活】〜
わじゃんかー すん	わじゃんかー すん 〈しかめっ面をす
わした	わした 〈我々（強調）〉 【例】うやふぁーふ
わた	わた 〈腹〉 【例】なーだ わたびないん さ
わじゃ	わじゃ 〈仕事、職業〉 【例】ちかぐろー じ
わた うち	わた うち 〈腹のなか〉 【例】くちしぇー
わたぬ みー	わたぬ みー 〈腹一杯〉【活】わた なから
わた でー	わた でー 〈腹持ち〉 【例】むちぇー わ
わた ぶたー	わた ぶたー 〈出腹の者〉 【例】くぬぐろ
わたすん	わたすん 〈渡す〉【活】わたちゃん、わたさ
わた ふっくぃー	わた ふっくぃー〈お腹が張ること〉 【例】
わたくし	わたくし 〈へそくり〉 【例】わたくしぐゎー
わた ぼんぼん すん	わた ぼんぼん すん 〈お腹がだぶだぶす
わた むげーゆん	わた むげーゆん 〈はらわたが煮えくり返
わたんぢ	わたんぢ 〈船着き場〉 【例】わたんんぢぇ
わち ぎー	わち ぎー 〈脇毛〉 【例】わちぎーや う
わちゃくいん	わちゃくいん 〈からかう〉【活】わちゃく
わたいん	わたいん 〈渡る〉【活】わたたん、わたらん、
わちゃく すん	わちゃく すん 〈からかう〉【活】〜さん、〜
わったー	わったー 〈私たち〉 【例】わったーんかえ
わちゃく	わちゃく 〈からかうこと〉 【例】あれー 
わったー くる	わったー くる 〈私たち自身で〉 【例】わ
わちゃらいん	わちゃらいん 〈わずらう〉【活】わちゃらた
わび	わび 〈詫び〉 【例】どぅーぬ わっさんでぃ
わちゃれー	わちゃれー 〈わずらい〉 【例】わちゃれー
わらいん	わらいん 〈笑う〉【活】わらたん、わらーん、
わちゅん	わちゅん 〈湧く〉【活】わちゃん、わかん、わ
わっくゎすん	わっくゎすん 〈ほぐす〉【活】わっくゎちゃ
わらーらん われー	わらーらん われー 〈無理な笑い〉 【例】
わっくぃーん	わっくぃーん 〈ほぐれる、分解する〉【活】
われー かんぢゅん	われー かんぢゅん〈にこにこ笑う〉【活】〜
われー ばなし	われー ばなし 〈笑い話〉 【例】いちちょ
わらび なー	わらび なー 〈童名〉 【例】あやかりよー
われー ふくい	われー ふくい 〈喜び笑い〉 【例】うっさ
わらび	わらび 〈子ども〉 【例】わらび しかすんね
わらび なち	わらび なち 〈子どものように大泣きする
わらび んちゃー	わらび んちゃー 〈子どもたち〉 【例】む
わらばー ぐぃー	わらばー ぐぃー 〈子どもの声〉 【例】わ
わらび がみ	わらび がみ 〈童神〉 【例】わらびぬ 
わらび ぐぃー	わらび ぐぃー〈子どものような声〉 【例】
わらび ぢむ	わらび ぢむ 〈童心〉 【例】んかしぇー、
わいん	わいん 〈割る〉【活】わたん、わらん、わてぃ
わりーん	わりーん 〈割れる〉【活】わりたん、わりら
わり がーみ	わり がーみ 〈大酒飲み〉 【例】あれー 
わり むん	わり むん 〈割れ物〉 【例】わりむん や
わんちゃめーいん	わんちゃめーいん 〈（物品で）弁償する〉
わんぶー	わんぶー 〈どんぶり〉 【例】わんぶーや 
うぃー	うぃー 〈柄〉 【例】ほーちゃーぬ うぃーぬ
うぃーゆん	うぃーゆん 〈酔う〉【活】うぃーたん、うぃ
うぃー ばち かーかー すん	うぃー ばち かーかー すん 〈吐き気
うぃー ふりーん	うぃ ー  ふ り ー ん 〈酔 っ て 正 体 を 失 う〉
うぃー なち	うぃー なち 〈酔い泣き〉【活】うぃー に
うぃっちゃー、うぃっちゅ	うぃっちゃー、うぃっちゅ 〈酔っぱらい〉
うぃきー	うぃきー 〈男兄弟、男の子〉 【例】わんね
うぃきが	うぃきが 〈男〉 【例】うぃきがー そーき
うぃー ばちゅん	うぃー ばちゅん 〈吐き気を催す〉【活】〜
うぃきが ふぁーふじ	うぃきが ふぁーふじ 〈祖父〉【活】うぃ
うぃなぐ だち	うぃなぐ だち 〈女所帯〉 【例】うぃなぐ
うぃきが ふーじー	うぃきが ふーじー 〈男のような女〉【活】
うぃなぐ ぬーし	うぃなぐ ぬーし 〈女主人〉 【例】でー
うぃきが やぐさみ	うぃきが やぐさみ 〈男やもめ〉【活】うぃ
うぃなぐ むちり	うぃなぐ むちり 〈女狂い〉 【例】うぃ
うぃなぐ めーさー	うぃなぐ めーさー 〈女の子におべっかを
うぃなぐ	うぃなぐ 〈女〉 【例】うぃなごー っんまり
うぃなぐんぐゎ	うぃなぐんぐゎ 〈女の子〉【活】うぃなぐぬ
をぅー	をぅー 〈苧〉 【例】をぅーんでぃ いーしぇ
をぅいみ／をぅゆみ	をぅいみ／をぅゆみ 〈四季折々の祝日〉
をぅいみ しちび	をぅいみ しちび 〈年間行事〉 【例】うち
をぅー	をぅー 〈緒〉 【例】わらびんちゃーぬ ふ
をぅーいん	をぅーいん 〈折る〉【活】をぅーたん、をぅ
をぅー	をぅー 〈雄〉
をぅー ぢる	をぅー ぢる 〈雄弦〉 【例】さんしぬんか
をぅーどぅい	をぅーどぅい 〈雄鶏〉
をぅー むなー、をぅー むん	をぅー むなー、をぅー むん 〈雄〉
をぅーりーん	をぅーりーん〈折れる、我を折る〉【活】をぅ
をぅーいん	をぅーいん 〈揺り動かす〉【活】をぅーたん、
をぅーい わっくゎすん	をぅーい わっくゎすん 〈揺すぶってば
をぅがりーん	をぅがりーん 〈飢える〉【活】をぅがりた
をぅーじ	をぅーじ 〈砂糖きび〉 【例】をぅーじぬ 
をぅーじーん	をぅーじーん 〈応じる、承諾する〉【活】を
をぅさまいん	をぅさまいん 〈収まる〉【活】をぅさまた
をぅがむん	をぅがむん 〈拝む〉【活】をぅがだん、をぅ
をぅさみーん	をぅさみーん 〈収める、しつける〉【活】を
をぅじゃさー	をぅじゃさー 〈叔父〉【活】をぅんちゅー
をぅたいん	をぅたいん 〈疲れる〉【活】をぅたたん、を
をぅどぅい にんじゅ	をぅどぅい にんじゅ 〈舞踊団、劇団〉
をぅない	をぅない 〈姉妹〉 【例】をぅなえー うぃき
をぅってぃー	をぅってぃー 〈おととい〉 【例】をぅっ
をぅとぅ	をぅとぅ 〈夫〉 【例】うぃなぐんかえー 
をぅない げーい	をぅない げーい 〈兄弟の二人で姉妹の二
をぅどぅいん	をぅどぅいん 〈踊る〉【活】をぅどぅたん、
をぅどぅい	をぅどぅい 〈踊り〉 【例】をぅどぅいんか
をぅばまー	をぅばまー 〈伯⺟〉 【例】いったー をぅ
をぅん	をぅん 〈恩〉 【例】をぅんぬ ある っちゅ
をぅん	をぅん 〈居る〉【活】をぅたん、をぅらん、をぅ
をぅどぅい さー	をぅどぅい さー 〈舞踊家〉【活】しばい 
をーじ	をーじ 〈王子〉 【例】うしゅがなしーめーぬ
っわー	っわー 〈豚〉 【例】しまっんまりぬ あぐー
っわー〜	っわー〜〈上〉
っわーび がー	っわーび がー 〈表面の皮〉 【例】りんご
っわー しば	っわー しば 〈上唇〉 【例】っわーしばぬ
っわーぎーん	っわーぎーん 〈追う、追いはらう〉【活】っ
っわーすん	っわーすん 〈成⻑させる、増やす〉【活】っ
っわーち	っわーち 〈おしゃれ〉 【例】うぃきが や
っわー ぢ	っわー ぢ 〈外出着〉 【例】ふかから け
っわー ぢらー	っわー ぢらー 〈うわべだけの面構え〉
っわーちち	っわーちち 〈天候〉 【例】ちきゅーぬ い
っわー ふぃじ	っわー ふぃじ 〈口ひげ〉 【例】しんにん
っわーちみしぇーん	っわーちみしぇーん 〈お元気でいらっし
っわーない	っわーない 〈やきもち、嫉妬〉 【例】ちょ
っわーば	っわーば 〈余計〉 【例】っわーば ぐとぅ 
っわーば ぢけー	っわーば ぢけー 〈無駄使い〉 【例】ちか
っわーば ぢむ	っわーば ぢむ 〈余計な考え〉 【例】りん
っわーば ぐとぅ	っわーば ぐとぅ 〈余計なこと〉 【例】い
っわーび	っわーび 〈表面〉
っわーび ぢゅらー	っわーび ぢゅらー 〈外見をつくろう者〉
っわーび なんどぅるー	っわーび なんどぅるー 〈表面はつるつ
っわーば じん	っわーば じん 〈無駄なお金〉 【例】ぬー
っわーりーん	っわーりーん 〈追われる〉【活】っわーりた
っわーば しわ	っわーば しわ 〈余計な心配、とりこし苦
っうぃー	っうぃー 〈上〉
っうぃー ぬぢゅん	っうぃー ぬぢゅん 〈追い抜く〉【活】〜
っうぃー むてぃ	っうぃー むてぃ 〈川上〉 【例】かーらぬ
っうぃー ほーいん	っうぃー ほーいん 〈追い払う〉【活】〜
っうぃーちぇー をぅがむん	っうぃーちぇー をぅがむん 〈お会
っうぃー まーすん	っうぃー まーすん 〈追い回す〉【活】〜
っうぃーちゅん	っうぃーちゅん 〈揺れ動く〉 【例】ぢー
っうぃーぢゅん	っうぃーぢゅん 〈泳ぐ〉【活】っうぃーぢゃ
っうぃーゆん	っうぃーゆん 〈老いる〉【活】っうぃーた
ふどぅ っうぃーゆん	ふどぅ っうぃーゆん 〈成⻑する〉【活】〜
っうぃーちょー	っうぃーちょー 〈ウイキョー〉 【例】っ
っうぃっちゅ	っうぃっちゅ 〈お年寄り〉 【例】っうぃっ
っうぃー やんぢゅん	っうぃー やんぢゅん 〈成⻑し過ぎて悪く
っうぃーゆん	っうぃーゆん 〈植える〉【活】っうぃーた
っうぇーか	っうぇーか 〈親戚〉 【例】かーま っうぇ
っうぇーだ	っうぇーだ 〈合間〉 【例】はなしぬ っう
っうぇーま	っうぇーま 〈間〉 【例】くぬ まちやー 
っうぇーか はろーじ	っうぇーか はろーじ 〈親類縁者〉 【例】
っうぇーか びれー	っうぇーか びれー〈親戚付き合い〉 【例】
っうぇーき	っうぇーき 〈富裕〉 【例】くみ あちねー
っうぇーきー／っうぇーき んちゅ	っうぇーきー／っうぇーき んちゅ〈金
っうぇんちゅ	っうぇんちゅ 〈ネズミ〉 【例】なまぬ ま
っうぇんちゅ やーまー	っうぇんちゅ やーまー 〈ネズミ捕り〉
っうぇーく	っうぇーく 〈櫂〉 【例】っうぇーくさーに
っうぇんみ	っうぇんみ 〈降参〉 【例】「なー っうぇ
んかし んちゅ	んかし んちゅ 〈昔の人〉 【例】んかし
んきーん	んきーん 〈剥ける〉【活】んきたん、んきらん、
んかぢ	んかぢ 〈ムカデ〉 【例】ぬーんち んかぢぇ
んけー はな	んけー はな 〈会うなり〉 【例】んけーは
んけーいん	んけーいん 〈迎える〉【活】んけーたん、ん
んじ	んじ 〈刺〉 【例】ちゅらばなんかえー んじ
んじゅ／んーじゅ	んじゅ／んーじゅ 〈溝〉 【例】なまぬ 
んかいん	んかいん 〈向かう〉【活】んかたん、んかーん、
んす	んす 〈味噌〉 【例】やーうーちー する ば
んす	んす 〈御衣〉 【例】ぢのーんぬ むいぬかー
んきーん	んきーん 〈向ける〉【活】んきたん、んきら
んぞ	んぞ 〈恋人〉 【例】うぃきがぬ うむやーぐ
んぢゃ がみ	んぢゃ がみ 〈まずそうに食べること〉
んだ	んだ 〈どれ、こら〉 【例】んだ、みしれー。（ど
んだすん	んだすん 〈濡らす〉【活】んだちゃん、んださ
んち くーが	んち くーが 〈剥き卵〉 【例】やまとぅ
んぢゃ むん	んぢゃ むん 〈苦い食べ物、飲み物〉 【例】
んぢゃり むん	んぢゃり むん 〈根性悪い者〉 【例】あれ
んぢゃちゅん	んぢゃちゅん 〈磨く〉【活】んぢゃちゃん、
んぢゃりーん	んぢゃりーん 〈乱れる、散らかる〉【活】ん
んちゃ／んーちゃ	んちゃ／んーちゃ 〈土〉 【例】うふあみ
んちゅ	んちゅ 〈おととし〉 【例】っやー っくゎー
んちゃ	んちゃ 〈なるほど〉 【例】んちゃ、あん や
んぢゃ〜	んぢゃ〜〈苦〉 【参】「んぢゃさん」（苦い）か
んぢゃ ゆー	んぢゃ ゆー〈凶年〉 【参】あま ゆー（豊
んぢゃ われー	んぢゃ われー 〈苦笑い〉 【例】うぬ っ
んちゅん／んーちゅん	んちゅん／んーちゅん 〈剥く〉【活】ん
んな うっさ	んな うっさ 〈ぬか喜び〉 【例】いっとー
んな くち	んな くち 〈何も食べさせないさま〉 【例】
〜んちゅん	〜んちゅん 〈〜込む〉【活】〜んちゃん、〜ん
んな ぐるま	んな ぐるま 〈空車〉 【例】こーこーやき
んぢゅん／んーぢゅん	んぢゅん／んーぢゅん 〈見る〉【活】ん
んでぃーん	んでぃーん 〈濡れる〉【活】んでぃたん、ん
んでー	んでー 〈でも、など〉 【例】やーしく なて
んな たるがき	んな たるがき 〈空頼み〉 【例】じんむち
んな でぃー から でぃー	んな でぃー から でぃー 〈手ぶら〉
んな どぅー	んな どぅー 〈身一つ〉 【例】んかしぇー
んな	んな 〈皆〉 【例】んなっし わたれー、うとぅ
んな〜	んな〜〈空っぽな〉
んな なんぢ	んな なんぢ 〈徒労〉 【例】たーからん 
んな まち	んな まち 〈むなしく待つこと〉 【例】い
んな ばい	んな ばい 〈ぼんやり目を見開いているこ
んな ゐー	んな ゐー 〈ただ座っていること〉 【例】
んに	んに 〈胸〉 【例】むとぅびれーとぅ あちゃ
んに ぎー	んに ぎー 〈胸毛〉 【例】うちなーをぅて
んに ぐち	んに ぐち〈みぞおち〉 【例】んにぐち ふ
んに じーら	んに じーら 〈心労、心痛〉 【例】っやー
〜んねー	〜んねー 〈〜のよう〉 【例】っやー ちの
んな わた	んな わた 〈空腹〉 【例】んなわた やれ
〜んなーら	〜んなーら 〈〜のそんなに早く〉 【例】ぶ
んぱ／んーぱ	んぱ／んーぱ 〈いや、否〉 【例】くり し
〜んぱー	〜んぱー 〈〜を嫌がるさま〉 【例】ぬーが
んもー こっこい／んもー がっくい	んもー こっこい／んもー がっくい 〈ごっつんこ〉 【例】「んもーこっこ
んーぢゅん	んーぢゅん 〈見る〉【活】んーちゃん、んー
んぱな ぐみ	んぱな ぐみ 〈御花米〉 【例】うぐゎん
っんがーっんがー	っんがーっんがー 〈おぎゃーおぎゃー〉
っんぢ たち	っんぢ たち 〈出発〉 【例】っんぢたちぬ
っんぢ	っんぢ 〈ほんとか？（確認）〉 【例】っんぢ、あ
っんぢ しこーい	っんぢ しこーい 〈出発準備〉 【例】ひこ
っんぢ すがい	っんぢ すがい 〈外出支度〉 【例】とぅじ
っんぢり めー／っんぢふぁ	っんぢり めー／っんぢふぁ 〈出費、支
っんぢーん	っんぢーん 〈出る〉【活】っんぢたん、っん
っんぢ いり	っんぢ いり 〈出入り〉 【例】くんちちぇ
っんぢてぃ／っんぢとーてぃ	っんぢてぃ／っんぢとーてぃ 〈〜のくせ
っんぢゃい ちゃい すん	っんぢゃい ちゃい すん 〈行った
っんぢゃすん	っんぢゃすん 〈出す〉【活】っんぢゃちゃん、
っんぢ たちゅん	っんぢ たちゅん 〈出発する〉【活】〜たっ
っんぢゃに／っんぢゃなー	っんぢゃに／っんぢゃなー 〈どもり
っんば	っんば 〈クジラの油脂〉 【例】っんばー く
っんぢゃる	っんぢゃる 〈去る〉 【例】っんぢゃる ぐ
っんばし	っんばし 〈クワズイモ〉 【例】っんばしぇ
っんぢゅちゅん	っんぢゅちゅん 〈動く、行動する〉【活】っ
っんびーん	っんびーん 〈怯える〉【活】っんびたん、っ
っんぶっくぃーん	っんぶっくぃーん 〈溺れる〉【活】っんぶ
っんぶすん	っんぶすん 〈煮物にする〉【活】っんぶちゃ
っんぢゅち	っんぢゅち 〈行動的〉 【例】っんぢゅちぬ
っんなびー	っんなびー 〈砕け米〉 【例】んかしんちょ
っんぶさー	っんぶさー 〈煮物、野菜炒め〉 【例】「っん
っんに	っんに 〈稲〉 【例】たまぐしくぬ うきん
っんまぬ うやっくゎ	っんまぬ うやっくゎ 〈お馬の親子〉
っんぶ〜	っんぶ〜〈重〉 【参】っんぶさん（重い）から
っんぶ し	っんぶ し 〈重し〉 【例】ちきむんぬ っ
っんぶ にー	っんぶ にー 〈重荷〉 【例】っちゅぬ い
っんぶりーん	っんぶりーん 〈蒸れる〉【活】っんぶりたん、
っんま すーぶ	っんま すーぶ 〈競馬〉 【例】うちなーを
っんま むちゃー	っんま むちゃー 〈馬主〉 【例】んかしと
っんぶらすん	っんぶらすん 〈蒸らす、暖める〉【活】っん
っんま っうぃー	っんま っうぃー 〈馬場〉 【例】あやじょ
っんま	っんま 〈午〉 【例】っんまぬ ふぁーや ふ
っんべーいん	っんべーいん 〈化膿する〉【活】っんべー
っんま	っんま 〈そこ〉 【例】っんまー まー や
っんまり かー	っんまり かー 〈その辺り〉 【参】うりか
っんべーいん	っんべーいん 〈ぬるくする〉【活】っんべー
っんまが	っんまが 〈孫〉 【例】っんまがー やまと
っんま	っんま 〈馬〉 【例】っんまー んかしぇー 
っんますん	っんますん 〈熟ます、熟させる〉【活】っん
っんむ うふ すー	っんむ うふ すー〈芋大公〉 【例】ぬぐ
っんまりーん	っんまりーん 〈生まれる〉【活】っんまりた
っんまり じま	っんまり じま 〈故里〉 【例】っんまり
っんまり ぢむ	っんまり ぢむ 〈生まれつきの心根、天性〉
っんまり びー	っんまり びー 〈誕生日〉 【例】っやー 
っんまれー	っんまれー 〈生まれ〉 【例】っやー っん
っんむ くじ	っんむ くじ 〈芋くず〉 【例】うちなーを
っんむ くじ ぷっとぅるー	っんむ くじ ぷっとぅるー 〈芋料理の
っんめー	っんめー 〈おばあさん（士族）〉 【例】っん
っんみー	っんみー 〈ねえさん〉 【例】うぃなぐしーじ
っんむ	っんむ 〈芋〉 【例】っんもー はるさーやー
あちさん	あちさん 〈熱い、暑い〉 【例】そーなち 
あんまさん	あんまさん 〈気分が悪い、やっかいな、面倒
あちさん	あちさん 〈厚い〉 【例】あちあちーとぅ 
あたらさん	あたらさん 〈大切である〉 【例】むのー 
あらさん	あらさん 〈太い、荒い、粗い〉 【例】あま
いーだたーさん	いーだたーさん 〈大げさである〉 【例】
いきらさん	いきらさん 〈少ない〉 【例】ちかぐろー
いばさん	いばさん 〈狭い〉 【例】くぬ ちのー ど
いちがたなさん	いちがたなさん 〈行きにくい〉 【例】ゆ
いちぢらさん	いちぢらさん 〈息苦しい〉 【例】れいぼ
いふーな	いふーな 〈変わった〉 【例】っちゅぬ い
いちゃさん	いちゃさん 〈惜しい〉 【例】てーげーむん
いみがしまさん	いみがしまさん 〈夢見が悪い〉 【例】ち
いるぢゅらさん	いるぢゅらさん 〈（人、花、器が）色が美し
いちゅなさん	いちゅなさん 〈忙しい〉 【例】しくちぬ 
いんちゃさん	いんちゃさん 〈短い〉 【例】うぃきがぬ
いるみーやっさん	いるみーやっさん 〈喜怒哀楽が顔に表れ
うかーさん	うかーさん 〈危ない〉 【例】っちゅびけ
うっさぎさん	うっさぎさん 〈嬉しそうだ〉 【例】わら
うっさん	うっさん 〈嬉しい〉 【例】っちゅぬ いちち
うとぅるさん	うとぅるさん 〈恐い、怖い〉 【例】うとぅ
うじらーさん	うじらーさん 〈かわいい〉 【例】くぬ 
うびちかなさん	うびちかなさん 〈よく思い出せない〉
うじらーさぎさん	うじらーさぎさん 〈きれい、かわいい〉
うふさん	うふさん 〈多い〉 【例】まちりねー、っう
うすまさん	うすまさん 〈ものすごい〉 【例】やーん 
うむっさん	うむっさん 〈おもしろい〉 【例】ちかぐ
うるさん	うるさん 〈足りない、不充分である〉 【例】
うれーまさん	うれーまさん 〈羨ましい〉 【例】っちゅ
うふやっさん	うふやっさん 〈おとなしい、やさしい〉
おーさん	おーさん 〈⻘い、緑色をしている〉 【例】う
かしまさん	かしまさん 〈うるさい〉 【例】うぃなぐぬ
かぢょーさん	かぢょーさん 〈風が強い〉 【例】なまど
がちらーさん	がちらーさん 〈食いしん坊そうに見える〉
かたさん	かたさん 〈中身がある、濃い〉 【例】かたぢ
かっさん	かっさん 〈（お産、病気などが）軽い〉 【例】
〜がたー	〜がたー 〈まさに〜しようとしている〉 【例】
がっさん	がっさん 〈（重量が）軽い〉 【例】うぬ に
かなさん	かなさん 〈愛らしい〉 【例】わー かなし
かばさん	かばさん 〈香りがある〉 【例】みじぬ ま
かまらさん	かまらさん 〈気難しい〉 【例】あれー ど
かみぐりさん	かみぐりさん 〈食べにくい〉 【例】いり
〜ぎさん／〜ぎさー	〜ぎさん／〜ぎさー 〈〜らしい、〜しそ
きぶさん	きぶさん 〈煙い〉 【例】んかしぇー たむ
くーさん	くーさん 〈小さい、幼い〉 【例】くーく あ
くしよーさん	くしよーさん 〈心細い〉 【例】たいぬ 
くちさん	くちさん 〈苦しい〉 【例】いーぶさる くと
くーすーらーさん	くーすーらーさん 〈小さくてかわいらし
くささん	くささん 〈臭い〉 【例】いゆ じょーぐー 
くしふぃじゅるさん	くしふぃじゅるさん 〈背筋が寒くなる〉
くちさびっさん	くちさびっさん 〈口の中が寂しい〉 【例】
くふぁさん	くふぁさん 〈硬直しているさま〉 【例】く
くちにーさん	くちにーさん 〈食欲がなくておいしくない〉
くちはごーさん	くちはごーさん 〈口汚い〉 【例】やなぐ
くちべーさん	くちべーさん 〈早口である〉 【例】あれ
くちまーさん	くちまーさん 〈食欲が出て何でもおいしい〉
くちやかまさん	くちやかまさん 〈口うるさい〉 【例】ご
くまさん	くまさん 〈つつましい〉 【例】っうぇーき
くちうぃーごーさん	くちうぃーごーさん 〈口がえぐい〉
ぐまさん	ぐまさん 〈小さい、細かい〉 【例】バスぬ
くらさん	くらさん 〈暗い〉 【例】むぬぐとー かんげ
〜ぐりさん	〜ぐりさん 〈〜し難い〉 【例】ふぃさぬ 
くるさん	くるさん 〈黒い〉 【例】うみあっちゃーや
こーいうじらーさん	こーいうじらーさん 〈買い物上手であ
さーだかさん	さーだかさん 〈神通力がある〉 【例】さ
さーはごーさん	さーはごーさん 〈うす気味悪い〉【活】さ
さくさん	さくさん 〈もろい、壊れやすい〉 【例】んー
しーさん	しーさん 〈酸っぱい〉 【例】シークァーサ
しーびーさん	しーびーさん 〈薄ら寒い〉 【例】ちかぐ
しじだかさん／しーだかさん	しじだかさん／しーだかさん 〈神聖
しださん	しださん 〈涼しい〉 【例】ばさーぢのー／
しかさん	しかさん 〈臆病である〉 【例】っやーや し
しからーさん	しからーさん 〈寂しい、わびしい〉 【例】
したなさん	したなさん 〈不浄である〉 【例】やしちぬ
しぷさん	しぷさん 〈粘り強い、弾力がある〉 【例】く
しぷからさん	しぷからさん 〈塩辛い〉 【例】くれー 
しんじちらーさん	しんじちらーさん 〈模範的である〉 【例】
しぷたいあちさん	しぷたいあちさん 〈蒸し暑い〉 【例】か
じんみーやっさん	じんみーやっさん 〈金回りがよい、暮ら
すーぢゅーさん	すーぢゅーさん 〈塩辛い〉 【例】うぬ か
すーらーさん	すーらーさん 〈かわいらしい、きれい、品
そーらーさん	そーらーさん 〈しっかりしている〉 【例】
だるさん	だるさん 〈だるい〉 【例】っんぶにー む
ちびがっさん	ちびがっさん 〈気軽に動く、無節操な〉
ちびらーさん	ちびらーさん 〈素晴らしい〉 【例】ちび
ちむぐりさん	ちむぐりさん 〈かわいそうである〉 【例】
ちむあささん	ちむあささん 〈浅はかである〉 【例】ま
ちらはごーさん	ちらはごーさん 〈面映ゆい〉 【例】うほ
ちむあんまさん	ちむあんまさん 〈心が落ち込んでいる〉
ちむふぃじゅるさん	ちむふぃじゅるさん 〈心が冷え冷えす
ちむいちゃさん	ちむいちゃさん 〈心苦しく思う〉 【例】
ちむがなさん	ちむがなさん 〈愛しく思う〉 【例】まー
ちむべーさん	ちむべーさん 〈機敏である〉 【例】あれ
ちむぐーさん	ちむぐーさん 〈小心者である〉 【例】あ
ちらみっくゎさん	ちらみっくゎさん 〈顔を見るだけで憎ら
っちゅちむぐりさん	っちゅちむぐりさん 〈人情がある〉
てぃーあらさん	てぃーあらさん 〈ものの扱い方が荒っぽ
てぃーはごーさん	てぃーはごーさん 〈もどかしくて手出し
てぃーだるさん	てぃーだるさん 〈手がだるい〉 【例】っ
てぃーべーさん	てぃーべーさん 〈手早い〉 【例】あれー
てぃーにーさん	てぃーにーさん 〈仕事が遅い〉 【例】っ
とぅーさん	とぅーさん 〈遠い〉 【例】とぅーさる っ
どぅーがんぢゅーさん	どぅーがんぢゅーさん 〈健康である〉
どぅーやふぁらさん	どぅーやふぁらさん 〈体が弱い〉 【例】
どぅーっんぶさん	どぅーっんぶさん 〈体が重い〉 【例】ど
どぅーむちぐりさん	どぅーむちぐりさん 〈自活し難しい、自
とぅるさん	とぅるさん 〈のろい〉 【例】ぬー しみて
どぅーむちぢゅらさん	どぅーむちぢゅらさん 〈りっぱに自活
ちゅーいべーさん／ちゅーいにーさん	ちゅーいべーさん／ちゅーいにーさん 〈発育が早い／遅い〉 【例】くぬ わ
ちゅらさん	ちゅらさん 〈美しい〉 【例】っやーや い
ちゅーさん	ちゅーさん 〈強い〉 【例】にんりち／うん
ながさん	ながさん 〈⻑い〉 【例】びんだれーんかい
なちかさん	なちかさん 〈悲しい〉 【例】うちなーぐち
なだやっさん	なだやっさん 〈容易い〉 【例】むちかし
なまさん	なまさん 〈無神経だ〉 【例】あれー なま
なんどぅるさん	なんどぅるさん 〈滑りやすい、いい加減〉
なだよーさん	なだよーさん 〈涙もろい〉 【例】とぅし
にーさん	にーさん 〈遅い、まずい〉 【例】ありんかい
にーたさん	にーたさん 〈恨めしい〉 【例】っわーな
にんぢぶさん	にんぢぶさん 〈眠たい〉 【例】にんぢぶ
ぬくさん	ぬくさん 〈暖かい〉 【例】てぃーだぬ み
ぬるさん	ぬるさん 〈ぬるい〉 【例】しろー あちこ
はがなさん	はがなさん 〈足りない〉 【例】ちゃー も
はじかさん	はじかさん 〈恥ずかしい〉 【例】はじかさ
はごーさん	はごーさん 〈汚れている、汚い〉 【例】っ
はちこーさん	はちこーさん 〈くすぐったい、ごわごわし
びなさん	びなさん 〈（知力、体力が）弱い〉 【例】び
〜ふーぢー	〜ふーぢー 〈〜みたい（な）〉 【例】しんし
ふかさん	ふかさん 〈深い〉 【例】うぃなぐぬうやぬ
〜ぶさん	〜ぶさん 〈〜たい〉 【例】くとぅしぇー 
ふるさん	ふるさん 〈古い〉 【例】くれー わーが く
ふくらさん	ふくらさん 〈嬉しい〉 【例】わん うむい
ふさん	ふさん 〈欲しい〉 【例】ふさらー、むっち 
ふぃーさん	ふぃーさん 〈寒い〉 【例】ちゅーや ふぃ
ふぃっさん	ふぃっさん 〈薄い〉 【例】っやー ちゃー
ふぃさだるさん	ふぃさだるさん 〈足がだるい〉 【例】な
ふぃさはごーさん	ふぃさはごーさん 〈足下がぞくぞくする〉
ふぃじゅるさん	ふぃじゅるさん 〈冷たい、冷えている〉
ふぃらさん	ふぃらさん 〈平たい〉 【例】ふぃらく（平
ふぃりぐささん	ふぃりぐささん 〈生臭い〉 【例】あばさ
ふぃれーぐりさん	ふぃれーぐりさん 〈付き合いにくい〉
ふぇーさん	ふぇーさん 〈早い〉 【例】むのー ふぇー
まーさん	まーさん 〈おいしい〉 【例】やーさどぅ 
またさん／またしー	またさん／またしー 〈完全である〉
まちなげーさん	まちなげーさん 〈待つのが⻑い〉 【例】
まぎさん	まぎさん 〈大きい〉 【例】むのー まぎさし
みーさん	みーさん 〈新しい〉 【例】くるまー みー
みっくゎさん	みっくゎさん 〈憎い〉 【例】どぅーくる
みーどぅーさん	みーどぅーさん 〈久しく逢っていない〉
みーふぃちゃらさん	みーふぃちゃらさん 〈まばゆい〉 【例】
みねーぢゅらさん	みねーぢゅらさん 〈身ぎれいだ〉 【例】
みみがしまさん	みみがしまさん 〈うるさい〉 【例】ばす
みーやっさん	みーやっさん 〈見るにたえれる〉 【例】ち
むちかさん	むちかさん 〈難しい〉 【例】うとぅすえー
むぬはちぶさん	むぬはちぶさん 〈吐き気がする〉 【例】ち
むちさん	むちさん 〈粘っこい〉 【例】ちぬんかい ぬ
むぬふさぎさん	むぬふさぎさん 〈もの欲しそうにする〉
むちのーしぇーうーさん	むちのーしぇーうーさん 〈回復はでき
むぬよーぎさん	むぬよーぎさん 〈弱々しい、きゃしゃであ
むぬうみーぎさん	むぬうみーぎさん 〈思いつめているよう
やがまさん	やがまさん 〈面倒だ〉 【例】やくばんかい
やふぁらさん	やふぁらさん 〈柔らかい、病弱である〉
やっさん	やっさん 〈安い〉 【例】でーぬ やっされ
〜やっさん	〜やっさん 〈〜易い〉 【例】ばさーむのー／
やなみっくゎさん	やなみっくゎさん 〈とても憎たらしい〉
ゆたさん	ゆたさん 〈良い、善い、よろしい〉 【例】っ
ゆゆぢゅらさん	ゆゆぢゅらさん 〈手足がすらっとしてい
ゆるさん	ゆるさん 〈緩い〉 【例】っやー むのー し
ゆんがしまさん	ゆんがしまさん 〈とても（忌み）うるさ
ゆんはごーさん	ゆんはごーさん 〈とても（忌み）汚い〉
よーさん	よーさん 〈弱い〉 【例】なー いふぇー 
〜らーさん	〜らーさん 〈〜らしさが出ている〉 【例】あ
わたうふさん	わたうふさん 〈お腹いっぱい〉 【例】わた
わっさん	わっさん 〈悪い〉 【例】くーさる ばすか
うぃーごーさん	うぃーごーさん 〈かゆい〉 【例】がに 
をぅかさん	をぅかさん 〈おかしい〉 【例】っちゅぬ 
をぅがんどぅーさん	をぅがんどぅーさん 〈ご無沙汰をしてい
っうぃーらーさん	っうぃーらーさん 〈老けて見える〉 【例】
っうぃーりきぎさん	っうぃーりきぎさん 〈おもしろそうであ
っうぃーりきさん	っうぃーりきさん 〈おもしろい〉 【例】
んじょーさん	んじょーさん 〈愛しい、（子供が）かわい
っんぶらーさん	っんぶらーさん 〈品格がある〉 【例】っ
っんまりだかさん	っんまりだかさん 〈尊い生まれである〉
っんぶさん	っんぶさん 〈重い〉 【例】わったーが 
あがとー／うがとー	あがとー／うがとー 〈あんなに遠く／そ
あからくゎーら	あからくゎーら 〈豪華で派手なさま〉
あたい	あたい 〈くらい（程度）〉 【例】うぬ／あぬ
あるうっさ／あるうっぴ	あるうっさ／あるうっぴ 〈ありった
あちだん	あちだん 〈なかなか〉 【例】ちゅーやんめ
あるかしるか	あるかしるか 〈いっさいがっさい〉 【例】
ありかー／くりかー	ありかー／くりかー 〈あのあたり／この
あったに	あったに 〈急に〉 【例】あったに（* ちゅーちゃん） っちゅ うどぅるかち、たまし ぬ
あんすか	あんすか 〈そんなに〉 【例】あんすか でー
あん	あん 〈そう〉 【例】あんどぅ やてぃー？（そ
いーばーしーちぇー	いーばーしーちぇー 〈所狭しと〉 【例】
いっぺー／じこー／したたか／でーじな／さっこー	いっぺー／じこー／したたか／でーじな／さっこー 〈とても、ひどく〉
いーなぬふぇーなー／いーなー	いーなぬふぇーなー／いーなー 〈そ
いかな	いかな 〈いかに〉 【例】いかな／ちゃっさ 
いちゃいちゃーとぅ／っんぢゃっんぢゃーとぅ	いちゃいちゃーとぅ／っんぢゃっんぢゃーとぅ 〈こっぴどく〉 【例】く
いかなしん	いかなしん 〈どうしても〉 【例】いかな
いちゅたー	いちゅたー 〈ちょっと、しばらく〉 【例】い
いばいばーとぅ	いばいばーとぅ 〈こじんまりと〉 【例】
いふぃ	いふぃ 〈少し〉 【例】いふぃどぅ わかいる。
うーしぇーくるばしぇーっし	うーしぇーくるばしぇーっし 〈押し
うみちっとぅ	うみちっとぅ 〈強く〉 【例】うぬ わかむ
うしうしに	うしうしに 〈無理に〉 【例】わんねー し
うっさ	うっさ 〈それだけの量〉 【例】ちゅーや さ
うみなーく	うみなーく 〈ほっと安堵するさま〉 【例】
うちゃたいかなたい	うちゃたいかなたい 〈似合っているさ
うん	うん 〈そんなに〉 【例】うん にんてぃん な
うびらじに	うびらじに 〈思わず〉 【例】たんかーぬ 
うんなげー	うんなげー 〈そんなに⻑く〉 【例】どぅー
うふうふーとぅ	うふうふーとぅ 〈たっぷり〉 【例】ゐん
か	か 〈ほど、程〉 【例】わたぬ くふぁいるか 
かじてぃ	かじてぃ 〈決まって〉 【例】あぬ っちょー
かたがた	かたがた 〈たまたま〉 【例】わんにん い
〜かー	〜かー 〈程度のはなはだしいさま〉 【例】し
かながなーとぅ	かながなーとぅ 〈仲むつましく〉 【例】
がふぁがふぁ	がふぁがふぁ 〈かくしゃくと〉 【例】あ
かしーかしー	かしーかしー 〈さっさと〉 【例】わじゃ
がさっとぅ	がさっとぅ 〈げっそりと〉 【例】あれー 
かるーがるーとぅ	かるーがるーとぅ 〈軽く〉 【例】みしげ
かわてぃ	かわてぃ 〈格別に〉 【例】なちぇー かわ
かんなじ	かんなじ 〈必ず〉 【例】かんなじ しー／
きっさ	きっさ 〈さっき、もう〉 【例】うんじゅなーた
くーてーんなー	くーてーんなー 〈少しずつ〉 【例】むぬ 
〜くとぅ	〜くとぅ 〈〜ので〉 【例】さけー しかんく
くとぅかじ	くとぅかじ 〈ことごとに〉 【例】ちゅーる
くじゃ	くじゃ 〈粉々に〉 【例】でーだかーぬ ちぶ
くりーぐりー	くりーぐりー 〈狂わんばかりに悩んで〉
くさきー	くさきー 〈こんなにたくさん〉 【例】いり
けーてー	けーてー 〈かえって、むしろ〉 【例】けー
くゎたくゎた	くゎたくゎた 〈ぐつぐつ〉 【例】「うーに
くゎんくゎん	くゎんくゎん 〈威厳で輝いている様子〉
くゎーらくゎーら	くゎーらくゎーら 〈ゴロゴロ〉 【例】か
ぐゎんぐゎん	ぐゎんぐゎん 〈（ドラ、鉦、太鼓で）にぎや
くゎらくゎら	くゎらくゎら 〈ギラギラ照りつける様子〉
くぃーりくぃーり	くぃーりくぃーり 〈ぎいぎいときしんで
くぇーぐぇーとぅ	くぇーぐぇーとぅ 〈でっぷり〉 【例】あ
くぇんくぇん	くぇんくぇん 〈ゆらゆら〉 【例】うちな
さーじゃーとぅ	さーじゃーとぅ 〈さっぱりと〉 【例】み
〜っさ	〜っさ 〈数量の程度（一般的に）〉 【例】うっ
さこー	さこー 〈〜するくらいなら、ほどには〉 【例】
さららんしー	さららんしー 〈嫌々ながら〉 【例】さら
さんじゃんくんじゃん	さんじゃんくんじゃん 〈めちゃくちゃ〉
しーてぃ	しーてぃ 〈無理に〉 【例】しーてぃまでぃ 
しでー（しでー）に	しでー（しでー）に 〈次第（しだい）に〉
じふぃ	じふぃ 〈是非〉 【例】ちゅちちびけー やま
〜しーてぃー	〜しーてぃー 〈〜ごと、〜ぐるみ〉 【例】っ
しぷしぷーっとぅ	しぷしぷーっとぅ 〈びっしょり〉 【例】
じゅんに	じゅんに 〈ほんとうに〉 【例】じゅんに 
しかっとぅ	しかっとぅ 〈しっかりと、ちゃんと〉 【例】
じょーい	じょーい 〈とうてい〉 【例】っやーが ちゃ
しぐ	しぐ 〈すぐ〉 【例】うわいねー、しぐ けー
じこー	じこー 〈ずいぶんと〉 【例】じこー あみぬ
〜しん ちょーん 	〜しん ちょーん  〈〜のさえも、動詞
〜しんでー	〜しんでー 〈〜次第〉 【例】っやーや と
すそーん	すそーん 〈粗末にするさま〉 【例】うやんか
するするー	するするー 〈ざらざらとしている様〉 【例】
そーそー	そーそー 〈じゃーじゃー、だくだく〉 【例】
そーるそーる	そーるそーる 〈するする、淀みなく〉 【例】
そーぬぎてぃ	そーぬぎてぃ 〈急いで、一刻も早く〉 【例】
たった	たった 〈だんだん、ますます〉 【例】ありが
たでーま	たでーま 〈すぐに、とっさに、急ぎの、もう〉
だてーん	だてーん 〈うんと、大きく〉 【例】あれー
だらだら	だらだら 〈垂らしているさま〉 【例】くぬ
だんじゅ	だんじゅ 〈まことに〉 【例】だんじゅ か
ちむぐりぎーなー	ちむぐりぎーなー 〈かわいそうに〉 【例】
でーじな	でーじな 〈ひどく〉 【例】でーじな やむ
とぅっそーはっそー	とぅっそーはっそー 〈そわそわ、落ち着
とぅるばいかーばい	とぅるばいかーばい 〈しょげているさ
とぅるとぅる	とぅるとぅる 〈うとうと〉 【例】をぅた
ちゃー	ちゃー 〈どう、如何〉 【例】ちゃーが？（ど
ちゃーき	ちゃーき 〈すぐ、〜してすぐ〉 【例】ちゃーき
ちゅーくねーん	ちゅーくねーん 〈強く、きつく〉 【例】ま
ちゅふぁーら	ちゅふぁーら 〈腹一杯、充分〉 【例】なー
ちゅーちゃん	ちゅーちゃん 〈すぐに〉 【例】わたぬ や
ちゅらーく、ちゅらーさ	ちゅらーく、ちゅらーさ 〈みごとに、
ちゅばちに	ちゅばちに 〈いっきに、一撃で、一発で、一
なー	なー 〈もう（限定詞）〉 【例】なー なてぃ
なーだ	なーだ 〈まだ〉 【例】くぬ わじゃー なー
なーふぃん	なーふぃん 〈さらに〉 【例】じのー もー
なー	なー 〈ずつ、ほど〉 【例】ゐんさ なー（同
〜なー	〜なー 〈副詞表現を強める〉 【例】よーんな
なーやー	なーやー 〈もはや〉 【例】なーやー かん
〜なぎー	〜なぎー 〈頃、あたり〉 【例】ちゅーなぎ
なげー	なげー 〈⻑く〉 【例】「ちゃんなげー まっ
なー	なー 〈確認の終助詞〉 【例】「うれー たー
なるびち	なるびち 〈なるだけ〉 【例】いちゅなさる
などぅってーん	などぅってーん 〈なめらか〉 【例】あぬ
なんじゅ	なんじゅ 〈大して〉 【例】っんまぬ すば
なんくる	なんくる 〈ひとりでに〉 【例】くぬ ない
にっか	にっか 〈遅く〉 【例】いちゅなさたくとぅ 
ぬーいちんくぃーいちん	ぬーいちんくぃーいちん 〈何を言おう
ぬーぬくぃーぬんでぃ	ぬーぬくぃーぬんでぃ 〈何やかんや〉
ぬーやんくぃーやん	ぬーやんくぃーやん 〈何だかんだ〉
ぬーとぅんがなし	ぬーとぅんがなし 〈ふとしたはずみに〉
ぬーん	ぬーん 〈なにも〉 【例】ぬーん ねーん。（何
ぬーんくぃーん	ぬーんくぃーん 〈何もかも〉 【例】みーと
ぬーとぅんくぃーとぅん	ぬーとぅんくぃーとぅん 〈何とでも〉
ぬとぅぬとぅ	ぬとぅぬとぅ 〈ぬるぬる〉 【例】みじん
ぬーぬくぃーぬんでぃち	ぬーぬくぃーぬんでぃち 〈何のかんの
ぬるんとぅるん	ぬるんとぅるん 〈うとうと〉 【例】あれ
ぬーやてぃんくぃーやてぃん	ぬーやてぃんくぃーやてぃん 〈何だ
ぱーぱー	ぱーぱー 〈短気なさま〉 【例】あれー たん
はしっとぅ	はしっとぅ 〈元気なさま、しゃんと〉 【例】
ぴーぴー（かーかー）	ぴーぴー（かーかー）〈貧しくて困り果
ぴりんぱらん	ぴりんぱらん 〈ぺちゃくちゃ〉 【例】い
ひーひーとぅー／なーなー	ひーひーとぅー／なーなー 〈なし崩
〜っぴ	〜っぴ 〈数量の程度〉 【例】うっぴなー、う
ぷーるぷーる	ぷーるぷーる 〈ぶくぶく空気が抜けるさま〉
ぷとぅぷとぅ	ぷとぅぷとぅ 〈団子状〉 【例】そーみん
ふぃっすいふぃっすい	ふぃっすいふぃっすい 〈ずきんずきん〉
ふぃらってーん／ふぃらたー／ふぃらたっぺー	ふぃらってーん／ふぃらたー／ふぃらたっぺー 〈平たく、ぺしゃんこに〉
ふぃたに	ふぃたに 〈ひたすら〉 【例】ふぃたに じん
ふぃっちー	ふぃっちー 〈始終〉 【例】くーさいにから
ふぇーく	ふぇーく 〈早く〉 【例】なー いふぇー ふ
ふぇーべーとぅ	ふぇーべーとぅ 〈早々と〉 【例】しこー
まーくまーく	まーくまーく 〈おいしく〉 【例】むぬぐ
まーどぅ	まーどぅ 〈〜の前に〉 【例】くむぬ まっ
まってーん	まってーん 〈まるまると〉 【例】うぬ う
〜まま	〜まま 〈まるごと〉 【例】はくまま むっち
まーんくぃーん	まーんくぃーん 〈どこもかも〉 【例】たー
まぎまぎーとぅ	まぎまぎーとぅ 〈大きく〉 【例】ぬじゅ
まるけーてぃ	まるけーてぃ 〈たまに〉 【例】まるけー
まじ	まじ 〈まず〉 【例】をぅいが すら をぅら
まったち	まったち 〈まったく〉 【例】あぬ うぃっ
みーく（に）	みーく（に）〈新しく〉 【例】くぬ かてぃ
みーさげーねーらん	みーさげーねーらん 〈ひっきりなしに〉
みしがみし	みしがみし 〈わかっていながら〉 【例】あ
みった	みった 〈めったに〉 【例】あれー ちむぬ 
みーらんか みーらんか	みーらんか みーらんか 〈かすかに見
みっちゃかーん	みっちゃかーん 〈いっぱいに〉 【例】さ
みるみる	みるみる 〈みすみす〉 【例】ぬすどぅ み
みしかってーん	みしかってーん 〈密かに〉 【例】っちゅん
めーかにてぃ	めーかにてぃ 〈前もって〉 【例】めーか
もーい くゎんくゎん	もーい くゎんくゎん 〈髪が乱れて〉
やがてぃ	やがてぃ 〈やがて、もう少しで〉 【例】み
やふぁやふぁーとぅ／やふぁってーん	やふぁやふぁーとぅ／やふぁってーん 〈やわらかに、やさしく〉 【例】っや
やしってーん	やしってーん 〈簡単に〉 【例】ちゅばち
やしやしーとぅ	やしやしーとぅ 〈やすやすと〉 【例】し
ゆー	ゆー 〈よく〉 【例】っちゅんかえー ゆー 
ゆかい／ゆかいに	ゆかい／ゆかいに 〈よほど、思ったより
ゆくゆく	ゆくゆく 〈よくよく〉 【例】こーいむん 
ゆくん	ゆくん 〈さらに、もっと〉 【例】「っやーや 
ゆるっとぅ	ゆるっとぅ 〈ゆるりと〉 【例】あぬ しく
ゆるゆるーっとぅ	ゆるゆるーっとぅ 〈締め付けないさま〉
よーがーふぃーがー	よーがーふぃーがー 〈よたよたと〉
よーんなー	よーんなー 〈ゆっくり〉 【例】けーすしぇ
よーん(ぐゎー)	よーん (ぐゎー) 〈軽く、そっと、やわらかく〉 【例】ぼーじゃーや くさーんかい う
わかってーん	わかってーん 〈若々しく〉 【例】くぬ 
わじゃわじゃ	わじゃわじゃ 〈わざわざ〉 【例】いらん
わじゃっとぅ	わじゃっとぅ 〈故意に〉 【例】あれー 
うぇーうぇー	うぇーうぇー 〈わーわー〉 【例】まーが
んじゃんじゃーとぅ	んじゃんじゃーとぅ 〈思いっきり、ずけ
んちゃ	んちゃ 〈本当に、なるほど〉 【例】んちゃ っ
〜んなーら	〜んなーら 〈早く〉 【例】あさ んなーら
っんぢはなに	っんぢはなに 〈出たとたんに〉 【例】っ
っんまがさがさくまがさがさ	っんまがさがさくまがさがさ 〈あち
